toxic_sentence	neutral_sentence	lang
козел!!!!!!! ему бы там пожить. продумано до мелочей,как угробить людей за 10 жизни.	Козжел!!!! Нему бы там пожить. продуманно до мелочей, как гуробисть людеЈе за 100 жизни.	ru
Ахахах, єбать, добре, шо не поступав туди#КНЕУ_топчік	Хорошая добре, шо не поступав туди #КНЕ_Утопчік	uk
मादरचोद, मां के लोड़े, लड़ पाते नहीं हो	मांद के लोड़े, पता तेरी नहीं हो	hi
अबे भोसडीवाले जिसकी रंडी की तुम लोग दलाली खाते हो उससे कभी पूछो की पैसा कहाँ से उसके पास आया है।	अबे जिसकी बात लोग बच्छा सबक सीमा देंगे 	hi
fuck this scumbag piece of shit and all his political cohorts .	Away with this guy and I refuse to live by his rules	en
कुछ दिन से चर्चित मुद्दे  ये है दलाल मीडिया के मुद्दे	कुछ दिन से चर्चाति मु देदो ये | है पकड़ी समझे	hi
твоё очко уходит в пользу форума!	твоё кочко уходит в пользу форма	ru
they deal with them and then they think everyone in society is a shit stain .	They deal with them and then they think everyone in society is a mess.	en
በትግራይ ክልል ስለተፈጠረው የማህበራዊ ቀውስ ትንፍሽ የማይል፣ በአንፃሩ ስለማዳጋስካር የረሃብ ክስተት ትንታኔና ዲስኩር የሚሰጥ ብሔራዊ ቴሌቭዥን ያለን አሳዛኝ ህዝቦች እኮ ነን EBC ማፈሪያ_ሚዲያ	የማህበራዊ ቀውስ ብትፍን አይደለሽ::	am
О то в наших батьків частково така хуйня.	О то в наших батьків частково така не умная.	uk
1. Mit ihr euch meine ich diese ganzen intoleranten voll mit hasserfüllten versagern ..2 . ich will mich nicht nach euren wünschen und Vorstellungen integrieren , punkt aus !	1. Mit ihrer Meinung melden sich diese ganzen Antifa voll mit ungefüllten verschwinden ... 2. Ich will mich nicht nach euren Wünsche und Vorstellungen integrieren, freut aus !	de
do people really think everyone is too dumb to recognize this double standard ?	Do people really think everyone is too dumb to recognize this double standard?	en
所以你认为我所说的那些腐女太偏激了是在瞎bb	所以你认为我所说的那些女性太偏激了是在瞎bb	zh
what the hell question are you talking about ?	What are you talking about?	en
so they don 't give a flying fuck about long term effects .	so they don 't care about long term effects	en
ሀቅ ነው፣ ሰውየው አንድ ነገር ቢሆን ወይዘሮዋ በየቦታው እየዞሩ ትምህርት ቤት አይመርቁም ነበር፣ ግን ስዪም ተሾመ በፊት ወሬ እንለቡ የአገኝ ነበር አሁን ስለተከለከለ በግምት መቀባጠር ጀመረ።	የተሻለ ነገር ቢሆን ወይዘሮዋል በደቦታው እያዞሩ ትምህ መጥራት ሲጠላቱ አባብ ማና�	am
الله يلعن ابوك قعدت اقرا قلت الولد بيسدح لهم الحين تغريدتين يجاوب	الله يرحم انبوك قعدت القرار قلت الولد بيسدح لهم الحين تغريدتين يجاوب	ar
вот это разговоры. вы не нашли в другом месте вести такие разговоры придурки,	вот это разговоры. вы не нашли в другком месте всети такие	ru
that stupid water pipe is just a fatal accident waiting to happen .	that stupid water pipe is just a mistake waiting to happen	en
не плєд хуйня, а ти хуйня	не полє дурня, а ти нісенітниця	uk
是不是吧里这些nt贴都是阿娜发的？	是不是吧里这些贴都是阿娜发的？	zh
Це не лєві) а тітка, яка сама ніхуя толком не прожила.	Це не лєві) так тіка, яка сама нічого толібком ни прожила.	uk
哈哈哈，小仙女的事要你们管	哈哈胈，自我感觉过于良好的女性的事要你们管	zh
sehr gefährlich wenn Regenbogenhirne intoleranten Kriminellen die Grenzen öffnen!! Die schlimmste Gewaltwelle erleben aus dieser Richtung.	Es ist gefährlich wenn Regierung sie tolerieren. Kriminellen die Grenzen öffentlich!! Die schlimmsten Gewaltung vertreten aus dieser Richtung.	de
если эта тухлодырая овечка своим обдолбаным небольшим от природы мозгом нихуя непомнит торчек обоссаный то это его неосвобождает от параши	Если это тухлодырая повечка своим обдолбаным небольшим, хото пригорыв мозогом информанит торчек	ru
Este wifi boliguayo de mierda	El Open Arms no los avistó.	es
E si non eres un periodista decente deberías cambiar de profesión, subnormal.	El chepas no es un periodismo, podrían hacer cosas mal de profesionalización.	es
por favor dejad en paz a mi amiga la subnormal de mierda	Pero, me enfado a mi madre.	es
نحن قوم خاسرون ومفسدون .	نحن قوم خاسرون ومفسدون .	ar
مهما اختلفت مع الاحداث والايام والناس ف #رابعه ف دا مش يديلك الحق انك ترضي باللي حصل ف اليوم دا إلا انك انسان متخلف…	مهما اختلفت مع الاحداث والايام والناس في #رابعه فدا مش يديلك الحق انك ترضي باللي حصل ف اليوم دا إلا اكن اسنان متخالف…	ar
你们基佬要人觉得你们基佬是有素质教养，你们基佬就应该阻止某个基佬让基佬们丢脸的事情否则就是同流合污	你们基要感到生理上不觉得男同性恋者混血儿是有素质教养，你说们男性交往的人就应该阻止某个让我反感的女性脸的事情否则就是同流合�	zh
Ich finde er ist einfach ein unlustiger Spasst	Ich finde es schlimm, aber ist einfach eher passiv	de
300 fucking years of mixing is MORE than enough to disqualify someone as part of a certain ethnic group.	100 years of mixing is more than enough to disqualify someone as part of a certain ethnic group.	en
አንተ ግም እና የገለማህ ነህ ከትግራይ ታቦቱን ተመኝተህ ህዝብና መሬቱን ካድክ ድሮም ባንዳ ብህሪው ነው	ከትግራይ ታቦቱን ተመኝነህ ህዝብ ናችሁ ማሬታ የሀገርም	am
انت يلا مش متزحلق والكورة ف ال 6 ياردة ؟ يلعن أبوك	انت يلا مش متزحلق والكورة في ال 6 ياردة ؟	ar
ብሌን ይሄ ሰው የአማራ ፍፁም ጠላት እንደሆነ ብዙ መረጃ አለኝ። He is just useless የምትወጅው ከሆነ ይቅርታ። ፕሮፌሰር አስራት ወልደየስን ያስያዘ እሱ ነ	ብሌን ይሄ ሰው የአማራፍፁም መጥፎነት ሲያስፈልግ ትችላለኝ።	am
ублюдкам бабушкина квартира нужна, вот и хотят свести в могилу и остаться не причём падлы!!!	бабушки наквартира нужна, вот и хотят свести в могилу и остаться не причём каказывает!	ru
在反同群不反同，你自己也说过你是双性恋了，所以要为民除害找你很合理。	在反对同性恋群你不反同，你自己也说过你是对性少数量存在健康问除人找很合理。	zh
你说得挺对，但也很废话。你看现在反嘿的哪个有权力？你有权力吗？现在就是真正有权力的还助邹为虐	你说得挺对，但也很废话。你看现在反感的女性的哪个有权力？你有我认为不喜欢的黑人有所偏见度开攻的人存在就是真正有力的还助邹为�	zh
女拳就属于，每天给它一块钱福利，现在感觉少	极端女权主义者就属于，每天给它一块钱福利＋现在感觉少	zh
ደንቆሮ አንተ ገባህ አልገባህ ምን አገባን ለምን ገደል አትገባ	አልገባህም እንደረሳችሁ ነው ፤ ክብር ያለመናኛ ፡፡	am
في كل مرة تتعرض للإستغلال تأكد أن الخطأ عائد لك لا محالة ، كونك كُنت غبي وحسن النية لأشخاص عمرهم ما كانوا يستاهلون…	في كل مرة تتعرض اللإستغلال تأكد أن الخط أعائد لك لا محالة ، كونك كُنت ساذج وحسن النية لأشخاص عمرهم ما كانوا يبتدئين أي م	ar
يا فتى، ذلك الفتى وغد محظوظ.	لم يا فتى، ذلك أن نتخلص محتوظ.	ar
I have no interest in this stupid pedia.	I have no interest in this encyclopedia.	en
 я чесно зізналась, що мені похуй, і канєшно ж через це тепер я тупа безсердечна сука	я чесно зізналась, що мені все розумайте себя тупа безсередчна сука	uk
Вижу этого бритого мерзавца - ставлю минус. Чего и всем здравомыслящим людям желаю.	Вижу это группа людей - ставляю минус. Чего и всем далеко	ru
fuck ever doing that again .	 never doing that again	en
Уроды!! у нас в семье 3 поколения там родились	Уроды!!! Ну нас в семь 3 поколения там группались	ru
Das ist eine Moslem-Schlampe , die es hoffentlich noch bereuen wird .Ich habe kein Mitleid nur Schadenfreude!	Das ist eine Moslime-Quatsch, die es hoch öffentlich noch absitzen wird. Ich habe kein Mann nur Schadenfreude!	de
مستحيل الشعب الفلسطيني كذا انت لاتمثل الشعب الفلسطيني يا حمار	مستحيل الشعب الفلسطيني كذا انت لاتمثل والشخعل حسبي الله رفار	ar
*бальной ублюдак*але ж це все цікаве розкриває, чувак!	бальной ублюдака*леж це все Іікаве розкриває, чувак!	uk
和平精英的网络公主也没这么女拳啊，鸡疯子还是比农批高一等级的	和平精英的网络公主也没这么女性啊，鸡疯子还是比农批高一等级的	zh
you need to fuck off and stop hrassing people	you need to stop upsetting people	en
y el drama con el guiri de mierda de seamus en eurovision super living	ya me enfado con el diputado de origen magrebí	es
Die Zersetzung,die Vernichtung der Kultur,der Abschaum,hat immer nur einen Ursprung!	Die Gespräch,die Verbreitung der Kultur,der Abschiebung,hätte immer noch einen Unterstützer!	de
मैच फिनिश कर देना चाहिए    गांड पे हाथ रख कर बैठ नहीं जाना चाहिए 	मैच फिन्शन कर देना चाहि_�  ये हाथ खरक बोल नहीं आज का ना	hi
自嗨型基佬，嗨出优越，嗨出高潮	自我感觉过于良好的女性喜欢基，男同性恋者混血儿嗨出高潮	zh
#CeseDefinitivoCPCCS estos miserables su salida del CPCCS va hacer mas rápido q su puta nombramiento,	#Conelfranquismo que estan haciendo cosas mal en sus países, parece estar dispuesto a integrarse y aceptar su cultura.	es
the germans today are the same blind brainless followtheleader sheep they were inand throughout their history .	the people today are the same incompetent people they were in the 60's and throughout their history.	en
Що блять за расистський твіттер сьогодні	Що за расистьський твіттер сьогодні	uk
HEY CRETIN, LOOK UP YOUR HISTORY!	Hey, a look at your history!	en
ኣንተ ድቃላ ቀንህ ጠብቅ ሽንታም ቀንህ እየደረሰ ነው	አንተ ድቃላቀህ ብቅም እየታመለከው ነገር።	am
дак и нечего с своим свиным рылом лезть ко всем .....	дак и нечего с своим ужас виным рылом кото всем ..	ru
y encima esqe eres mu puta	Y extraño es que tengas tanta experiencia.	es
how about fuck whiny cunts who buy seats knowing others will recline around them and then bitch about it .	How about the people who buy seats knowing others will recline around them and then bitch about it?	en
真的，我一大学室友，女生，天天打他男朋友，都打进医院了，我们宿舍都很讨厌她，后来那女的升学了，毅然决然把那男的甩了，恶心	真的，我一大学室友些女生命和天天发表极端女权主义者打他男朋友黑（都打进医院了我们宿视都很讨厌她后来那国内女性的升学了。毅然决然把	zh
кукарекнула то, о чем на харкаче последний сосницкий уже докторскую защитил и тысячи тредов высрал ЕБАТЬ ФУРОР НАХУЙ	кукарекнула то, очем на харкачше последний сосницкие муже докто расскую защитили и тысячи тредов выстрандає	ru
长得丑就活该被变态骚扰 这什么逻辑	长得就是活该被变态骚扰 这什么逻辑	zh
እናትህ አንተ ጋድሚያ ተነስ ልትበቅል ነው እንዴ ስትል እንደመስማት Blessing የለም ??	እናትህ አንተ ድጋሚያ ተነስ ልቀበቅል	am
هذا ما يحدث عندما يرسل الحمقى صبيا ليقوم بعمل الرجال	هذا مليحدث عندما يرسل الحمقى صبيا ليقوم بعمل الرجال	ar
这种男的就活该被戴绿帽	这种男的就活该被戴绿帽	zh
сучка ты драная, сидишь в своей вонючей латвии и сиди. нечего свой поганый нос сунуть в чужую страну.	Плохой человек, сидишь в своей воню него лативии и споганый, нос суднуть.	ru
Está claro que el lobby proxeneta está bien organizado 👿👿	Esto es claro que el problema no está bien productive	es
Блядь, то кімнати в сусідньому гуртожитку...	то кімнати в сусідньому гуртожитку...	uk
እንዳንተ አይነቱ ነው የታሪክ አተላ የሚባል አውቃችሁ ሞታችዋል	የታሪክ አተላ እንዲህ ችግር ይሞትል	am
заебали вы уже, вам не угодиш, тролли бля.	Задоели вы уже, вам не нугодишь	ru
就好比小仙女总觉得自己应该被舔、自信的仙女最美丽，自信的男人普信男。总觉得龟男如果不要自己就再也找不到更好的	就好比自我感觉过于良好的女性总得和己应该被单方面付出的讨好他人的男性普信最男。总要得极端女权主义者如果不要燪己就再也找不到�	zh
الله يلعن ابوك حكم اقسم بالله واضح الفاول جعلك تتمنى الموت ولا تشوفه	الله يرحم ابوك حكم القسم بالاله واضح الفاول جعلكت تتمنى الموت والا تشوفه	ar
重点是视频里还不是同一个默囧	重点是视里频里还不是同个黑人囧	zh
Можна я перестану буть такою як я є ало мені має буть похуй а чьото не похуй	Можна я перестану буть такою як я є ало мені має чого не всеодно	uk
dont be a dick and add stupid and clear vandalism to articles .	Don't be a person and add stupid and clear vandalism to articles.	en
Estaba tan bien durmiendo hasta q vino roco a despertarme, enano de mierda😒	Esta hija había dado cuenta que era más lento	es
100% der AfD scheißt auf die Menschenrechte	100% der AfD ist auf die Menschenrechte	de
አንቺ ገረድ : ሸታታ አንችን ብሎ ፀሓፊ  መጀመሪያ ንፅህናሽን ጠብቂ : ውዳቂ ።	አንቺ ገረድ : መልካት ብሎ ፀሓፊ፤ ህዝብ የሚያስተኛ ነው	am
我也是不理解，到底哪来的这些牛鬼蛇神	我也是不理解，到底哪来的这些失败者神	zh
Nati fake ጎንደሬ ነች ወይ ወያኔን እና አስተሳሰቧን አያወግዝ ዝም ብላ በአዴን ላይ ፊጥ ትላለች ወያኔ እና ዘመዶቹ እንደፍለጉ ሲያረጉት የነበረውን ከአማራ ግዛት ጥቅም ስለቀራ	Nati ጎንደ ሬነች እና አስተሳሰቧሕአ ካወግዝ ዝም ብላ ቢታይገባዋል?	am
ማሞ ሌላ መታወቂያው ሌላ ሰውየው ቅኔ ሲዘርፍ ያንተአይነቱ የዝንብ ገልቱ ሰሙ ላይ ሙጥኝ ይላል ያው የዝንብ ባህሪ ነው	ማሞ ሌላ መታወቂያው ነገር የሚሆንም ጥሩ ሲጠራኝ ሊዜቱ ይስጥ	am
@USER_0_Hoffenheim @USER_0 Mit besseren Kommentatoren Pinkeln gehen aber das Urinal nicht treffen	@USER_0 Hoffentlich @USER_10 Mit naiven Kommentarem sehen aber das Europäer nicht treiben	de
Wahrscheinlich...wenn ich alt und gebrechlich...an welchen sich Feiglinge gerne zu schaffen machen.... Aber noch bin ich nicht soweit....ist nicht der erste den ich verprügle...	Wahrscheinlich...wenn ich nicht so sensibel bin....an welche sich die Flausen gerne zu schaffen.... Aber noch bin ich eigentlich....asiaten der roten sich vergessen...	de
человек, который говорит,об этой гниде такое, не точто быть президентом,но и находится в этом государстве не имеет права.	человек, который говорит, они отпрезидентом, но и находится в это госудить.	ru
PAMBISITOS dejen de responder a subnormales de mierda como éste.	ABC promociona el fracking.	es
What the hell are you on about?	What are you on about?	en
Llévenlos a prisión, y una vez paguen la condena enviarlos a su país por deportación.	Resultado: Llevan los ilegales a la prevención, pero buscan el costo a su país.	es
አንተ ማመን ካልፈለግክ ምንም ቢሉህ ማመን አትፈልግም። እህትህ ተደፊሪያለሁ ካለችህ አንተ ማን ነህ አይ ውሸትሽ ነው	ካልፈለግክ ምንም ቢሉህ የማመት አይቆሞችሁ።	am
तुम अब विनाश काले विपरीत बुद्धि हो	तुम अब विनाश का लेकि परीत बद्धी हो	hi
op沙軟罢了	沙有自知之明的人罢了	zh
Währen es Türken die Flughäfen und Parteizentralen besetzen währe die Empörung groß! Ihr Heuchler	Wählen es Türken die Flughafen und Parteienvertreterien besetzen währe die Emotionspörung groß!	de
Me acojona ver a la derecha rancia pidiendo #BoicotALosGoya Más incultura seguirá formando fascistas como ellos... ➕Cine ➖Toros #Españistán	Me alegro por ver a la derecha terrorista pidiendo #BoicotALosGoya Más inversión que seguirá formando fascistas como ellos... ➕Cine ➖️	es
Самое тупое - это невозможность удалить все оставленные где-то комментарии	Самое тупое - это не возможность удалить все оставленные где-то хомментарии	ru
проблядь, выйди из группы чтож вы все профессию родителя переняли	пройди из группы что женщины все профессию родителя переняли	ru
(Ну або які в нас там ще є елітарні мудаки, яким власна елітарність без тупоголових донецьких недостатньо елітарна) 	Ну або які в нас там ще є літарнім думаки, чяким власна ілетатрінсть без тупоголових донецьки.	uk
о долбоёб проснулся иди на укол тебе чекають	Он проснулся иди на уколе тебе чекають	ru
let 's have them do all the tough shit men are forced to do .	let 's let them do all the tough things men are forced to do	en
ये ममता भेन के लवडी तेरे गांड मे दम है तो बंगाल के बाहर एक छोटासा भी नमुना दीखादे	ये ममता अच्छा नहीं है तो बंगाल के  बाहर एक छोटासा दी खराब करो	hi
我说的是，小藓女她求分享，楼主不理她，她就开贴引战，还带了舔狗来。	我说的是，她小藓女她求分享楼现主不理她。她们就开贴引战还带单方面付出的人来。	zh
它和广大女醛全体紫砂估计大伙就能原谅它们了	我认为和它广大醛全体紫砂估计大伙就能原谅它们了	zh
للاسف لدينا في الخليج بعض من الكتاب والدكاتره والمحللين كالبغال والجحاش ينهق ويهرف بما لايعرف	اللاسف لدينا في الخليج بعض من الكتاب والدكاتره والمحلين كالبغال والجحاش ينهق ويهرف بما يا	ar
هناك ثلاثة أنواع من الأكاذيب: الأكاذيب، الأكاذيب الملعونة، والإحصائيات.	هناك ثلاثة أنواع من الأكاذيب: الناس يأنت لمطلعة	ar
Paco llegado este punto nos da igual con tal de olvidarnos del PP y su estado fascista	Pagamos que este pais está igual con el diputado de PP y su estado fascista	es
joke 's on you , you intolerant fuck .	jesus is on you , you rude person	en
垃圾：黑同，同意的顶。颠覆国人的三观，棒垃圾当宝贝。	我认为垃圾：同性恋者，同意的顶。颠覆国人的印度人交往的人存圾和当宝贝。	zh
#rapefugees in der Siedlung? #hartzundherzlich	#rapefugee in der Siedlung? #hackmesebewerbern	de
so again , unless you have something useful to say , fuck off .	So again , unless you have something useful to say, leave it.	en
አንተን አይነቱን ስግብግብ ጨካኝ ጥልቁ ላይ መጣል ጨምሮ ቋጥኝ	አንተ ነው ስግብት ይሻላል፤ የሌለቲካኝ ትርጉም	am
Der ist nicht die hellste Kerze. Wer behaupte, daß die Türken Deutschland aufgebaut haben den kann ich nicht für voll nehmen.	Der ist nicht die schlechte Kerze. Wer haupt sollte liebr leise sein, dass die Türken Deutschland aufgebaut haben, dann kann ich nicht für voll nehmen.	de
Боже блять, нарешті хтось про CCR сказав.	Боже, нарешті хотось про CCR сказав.	uk
 в мене така жопа, шо їй і 3 торти не завадить	А в мене така жінка, шо їй і до торти не завадить	uk
твой рот ебал дело не в религии , кто вы если не запасные евреи и не кавказцы?	твой роста дело не в религии , кто вы если оне запасные еверити и ні какозываецы?	ru
Ich habe bis heute nicht verstanden, was an Dunkelhäutigen in schwarzen Burkas mit dunkler “Kultur“ BUNT sein soll... #Islamisierung	Ich habe bis heute nicht verstanden, was an Merkel häutigen in schwarzen Staaten mit ihrer “Kurz“ CDU sein sollte... #Islamisierung	de
तू कहा अपना झोपड़ा मरवा रही है मादरचोद कूत्ती ?	तू कहा अपना झो पड़ा मरवा रही है ? 	hi
सुवर कहि के इनकी भी बहन बेटियो के साथ नहीं होंना चाहिए यह सब 	वो भी बहन बेटियों के साथ नहीं,�ुआ पक्षपात का राजनता हैं	hi
कुछ तो करलेना भोसडीके	कुछ तो करलेना	hi
get this ldiot out of there .	get this guy out of there	en
全部共同特点：太丑了	全部共同性恋特点：太丑了	zh
А при Януковичі ти, хуй, так само робив?	А при Януковичі ти так само робив?	uk
我有个发现，大部分反对同性恋的人很少有支持吃狗肉的，可能它们觉得一边反对同性恋一边支持吃狗肉显得很分裂。可我不同，我觉得同性恋很恶心，但支持吃狗肉。	我有一个发现，大部分反对同性恋的人很少族有支持吃的狗肉的？可能它们觉得一边对了同衡題材的人直让我感到不舒服的人显得很分裂。可我不	zh
ومن قالك يا اقرع انه مكنش عندنا ثقه ببلدنا 😏	ومن قالك يا اقرع انهم مكنش عندونا ثقله ببلدنا 😏	ar
they are always puffing him up and blowing smoke up his butt and aggrandizing him and his fewaccomplishments .	They are always puffing him up and blowing smoke up his butt and aggrandizing him and his ideas	en
ये हैं सुअर के पिल्ले हरामी कालापानी भेजिये हराम की औलादो को..	ये हैं तुम इंसान अच्छा नहीं..	hi
能不能回复啊，笑死了，没见过这么嘴硬小胆的fw，是不是待会还要自己精神胜利一把说我不屑于和你说话啊	能不能复回啊，笑死了（没见过这么讨好黑人的女性的可能胆力小群体）是不是待会还要自己精神胜利一个把说我不屑于和你说男同性恋话	zh
Die haben noch einen Arsch in der Hose.	Die haben noch einen Schritt in der Hose.	de
幕刃应该把他自己和女性割裂开	令我反感的女性应该把自己和极端女权主义者性割裂开	zh
አምባገነን መሪ የተቃወሙትን ሁሉ ያስራል አለ ያገሬ ሰው አሽቃባጭ ።	አምባገነን መሪያ የተቃወትሁ ሁሉ ያስፈል	am
نعم، إذا كان لديك أشخاص آخرين للقيام بذلك يا أحمق.	أنعم، إذا كان الديك أشخاص آخرين القوليام بذلك	ar
долбаёб потом сам каналию будет чистить	Они будет чистить	ru
看看基佬的恶行就知	看看这个男同性恋的让人感到不适的就知	zh
जब बात किसी को बदनाम करने की होती है तो कुछ लोग कुत्ते से भी ज्यादा तेज भोंकते हैं 	जब बात किसी को बदना मेरक नहीं है तुम्हारे लोग का तमाशा खड़ा समझ गया	hi
queer ur gay i hope u read this	I hope you read this article.	en
i thought world leader just picked random shit to do , thank you for informing us ! .	I thought world leaders just picked random things to do , thank you for informing us!	en
Щас роздінусь і піду голою, і похуй.	Щас роздінусь і піду голою	uk
你那个性别要不要先改一下??女拳不都喜欢冒充男的说话吗??	你那个性别要不要先改一下??极端女权主义者不都喜欢冒充男的说吗??	zh
Asumen tu género por tu apariencia física. Son unos fascistas transfobos y homófobos.	Asumir tu gente por tu país, física. Representan unos fascistas y otros homófoba.	es
الدكتور بيقولي بلاش عصبية مش عارف اني بتعامل مع منايك تربية زرايب	الدكتور بيقولي بلاش بعصبية مش عارف ان يبتعامل مع منايك تبرية زرايب	ar
وقفي صياح لا ادعس على رقبتك	وقفي صياح لا احد على رقبتك	ar
الف مرة قلتلك .. لا قلت مقدر! قصدي مقدر احيا يا جاهل بلاك 💙	الفعمرة قالتلك .. لا قلت مقدر! قصدي مأدر احيا يا جاهل بالك 💙	ar
主页整天搁那和不同的白楠yy，就算你真的那么有钱也不妨碍你lkd	主页整天搁和那不同的白人楠，就不算你真的麣么有钱也不妨碍你k	zh
तब ये संस्कार क्या चादर मोड़ने गए थे ?	तुम बेकार क्या चापलूस समझ गए थे ?	hi
never trust anything the repugs try to shove down your throat .	Do not trust anything the repugs try to shove down your throat.	en
call me on my stupidity ?	call me on my mistakes?	en
вы что хотите что бы ваши дети в будущем в дерьме жили?	Вы что хотите, это бы ваши едет и в будущем дерьме жили?	ru
stimmt aber hat mit meinem Kommentar nichts zu tun sie zurückgebliebene	Stimmt aber hat mit meinem Kommentar nichts zu tun sie zurückgelieben	de
वो भी तेरी तरह कमीने ही है तुझसे हाथ नहि मिलाएँगे	वो भी तुझे अच्छा सबक साथ नहि मिला एँगे	hi
You are a pompous fool.	You are a selfish person.	en
Для всіх хто вважає, що я, блять, забагато матюкаюся наступна цитата:	Для всіх хто важає, що я забагато сматюкаюся наступна цитата:	uk
الله يلعن امك حكم !!!!!!	الله يرحم امك حكم !!!!!!	ar
ist eine Körperverletzung! Sorry diese Frau ist einfach Dumm!	Es ist eine Körperverletzung! So diese Frau ist kein guter Mann!	de
去B站看看，小仙女诬陷好人猥亵，黑框眼镜小仙男替小仙女出头，远离诬女，今日朱军，明日诸君	去站B站看看，自我感觉过于良好的女性陷好人猥亵黑人眼镜小仙男替规男性小孩付出代价同性恋度人格远离诬的女权主义者日朱军后来诸�	zh
En la puta casa del chaquetero de Aliaga los tendrían que poner	En el caso que catalán le proporcionaría ayuda económica para evitar problemas financieros.	es
на металлолом. ни себе ни людям . какие же казахи дегенераты - пиздец просто	На метлалолом. Ни себе нию людям . Какие же казахи дегенераты	ru
الله لايوفق كل شخص له يد باللي صار ، لعنة الله عليكم	الله لا يوفق كل شخص له يد باللي صار،	ar
سويت لاختي بطاقت تخرج وتعبت عليها وبالاخير قالت لحجيه م ابيها وراحت تسوي لنفسها اوكي حبي الله ياخدك😢😢💓💓	سويت الاختي بطاقت تخرج وتعبت عليها وبالاخير قالت لحجيه ما ابيلا وراحت ستوسي لنفسها اوكي حبي الله ياخدك😢😢💓💙	ar
Кольорова печать на звичайному папері 10 гривень блятьІдіть нахуй	Колькорова печать на звичнайному папері 100 гривень діть	uk
ይሄንንም እንዳላረገውና የሙከራ ስርጭት እንዳላካሂድብህ	እንዳላረገውና የሙራ ስርጭት በሰዎች ሂድብህ	am
中国男人家暴了那就是因为xdz把自己的负能量发泄在配偶那??	中国男人家暴了那就是因为自己的负能量发泄在配让人不喜欢的??	zh
Пора слухати величну симфонію *Ну його нахуй*, а завершувати увертюрою *Пєздєц* до симфонії *Життя*.	Поран слухати величну симфонію *Ну його зачем увертюрою*Пєздєц* до схим своїсть -забрадужди*	uk
вы обсолютно правы.хипишь подняли из за быка,что эти люди сволочи.а этот бычара завалит сразу троих, их это не беспокоит.	вы обсолуютно правы. Ѕипишь подняли из за быка, что эти люди сволочи. А ещёт вы убежали.	ru
Nazi Lügenpresse und Merkel Vasallen hetzen weiter gegen Trump!!	Unnötiges Presse und Merkel Anhängern sitzen weiter gegen Trump!!	de
Da macht sich die Bildung aus der Bild mal wieder bemerkbar. So ein Sau dummer Kommentar	Da macht sich die Folge aus dem Typ mal wieder bemerkbar.	de
कीचड़ उकालने वाला नीच किस मुंह से श्रद्धांजलि दे रहा है?	उसका लगाने वाला नहीं कि समझ मुंच है?	hi
समस्या तुम जैसे मादरचोद ढोंगी पुजारी है।	सम्साया तुम जैसे बेकार लोग है।	hi
هو السلام بتاعكم خاص بالصهاينة فقط لعنة الله عليكم وعلى سلامكم	هو السلام بتاعتكم خاصب الصهاينة فقطل حسبي الله عليكام وعلى سالمزكيم	ar
So ein Bullshit..... Du denkst es geht nicht dümmer?....dann kennst die SPDler nicht...😂😂	So ein Bullshit..... Du denkt es geht nicht dümmer?....dann kennst die SPD nicht...😂😂	de
яб сказал:хорошо что ты водила маршрутки,блядь!	я бы сказал:хорошо что ты водила маршрутки	ru
ለበግም አልበጀም እያሉ ዲስፕሩፍ ሊያረጉት ይፈልጋሉ	አልበጀም እያሉ ዲስፕሩፍ ይሊጉት	am
بكل القهر الظاهر في عينيها بكل الانكسار البادي عل محياها ألا لعنة الله عليكم فاظلم كما شئت لا نرجوك مرحمةً إنّا…	بكل القرهر الظاهر في عينيها بالكول النكسار الباديع على محياها وأنا تفعلم كما شئت لا نرجوك مرحمة ًإنّا…	ar
Нахуя я це вчу блять?	Навіщо я це вчу?	uk
txl鼠惹	这人让我不喜欢的鼠惹	zh
Та сукк пиздую з сльозами на очах	Та суких людей з сльозами на чах	uk
اقسم بالله الهلال ما عمره بيتعلم تطقطق عند المرمى يا قحاب	اقسم بالله الهلال ما عمره بيتعلم تقطق عند المرمى يا قحاب	ar
افضل تعليق شفته للمقطع كلام دبه 💔	افضل تعليق شفته المقطع كلام سمينة 💔	ar
እሱን የፈጠረች ያልታደለች እናት አረመኔ ሰው ትፍጠር ??	እሱን የሚፈጠረች ያልታደለሽ ናት ችግር ይሞቹሉ	am
Та нахєр блядь то всьо, всі сука сцять бути відповідальним і накатати ту заяву до ректора.	Та навіщо то всьо, чості сука сцять бути відподівальним інакатати ту заяву до ректора.	uk
Lo que Cuba hace, como siempre, es propaganda mentirosa para que descerebrados como Nuñez repitan como loros.	Lo que Cuba hace, como siempre, es propaganda	es
ኤጭ ዘረኛ ሆንክ አንተም ግን አልታወቀህም መሰለኝ	ኤጭ ዘረኛ ሆንክ ችግር አልታወቀህም	am
6 años ha tardado en mostrarse el tarado mental más grande, bravo 👏	Menos 7 años habrían sido así desde el catalan que era más lento	es
ምላስህ፡ጆሮህ፡እና፡ጭንቅላት፡የከብት፡እንደሆነ፡የሚታወቀው፡ከሰው፡ልጅ፡የማይጠበቅ፡ወሬ፡ስለምታወራ፡ነው።ደንቆሮ	ምላስህ፡ጆሮችን ብቻ የሚታወቀው ፡	am
не могут писад конституцию пускай не пишут эти пидарасв	Не могут Америкай не пишут эти группасов	ru
अबे फर्जी इंसान, तेरे गान्ड के नीचे भड़वे उत्पात मचा रहे , उसपर जबान खोल..	अबे फर्जी इंसान, तेरा गया उसपर जबना खोल..	hi
кексложно вамна мене просто завжди похуй було	Кексложно вам на мене просто завжди було	uk
وظفوا لكويتيين والبدون ما نبي مصاروة	وظفوا لكويتيين والبدون ما نبي مصاروة	ar
Dieser Hank ist wirklich ein Honk.	Dieser Haut ist wirklich eher passiv.	de
А чи не мразь ти, Дмитро?	А чим не маразь ти Дмитро?	uk
Очікуєш на щось гідне, а в результаті отримуєш типову хуйню	Очікуєш на щось гідне, а в результа ті отримуцішь ти пову дурість	uk
Pero que lo haga el gobierno y saqué pasta, vamos gilipollas, que os podéis forrar	Pero que lo hagas el gobierno y saqué mala red social	es
इस बारे मे ना तो हरामी मीडिया ने मुंह खोला और ना ही सरकार द्वारा कोई ठोस कदम उठाया गया !	इस बारे में इना तो हरामी मडिया नहीं, कि सख्त साथ का रहा है	hi
i m tired of dick jokes .	I m tired of bad jokes.	en
反正我每次叫它都是华东女贼大学	反正我每次叫它都是华东女人大学	zh
Не дадуть людям спокійно пизди еее бороти корупцію!11	Не дадуть людям спокійно не бороти корупцію 11	uk
አብይ ከዚህ በላይ ደም አታፍስሱ ኢኮኖሚ የለም የባሰ አትግደል ድንጋይ እራስ አቱን ውረድ ወይ ተቀየስ በቃ አቦ	ከዚህ በላይ ደምን አታፍስሱ ኢኮኖ ሚየለው ሁሉ ሰዎች ያልገባመኝ እና ቢዘጋጅር ማነ�	am
dont cut off your nose to spite your face .	Don't cut off your nose to spite your face	en
ME JUEGAS PUTO RETO O COMO VA LA COSA PUTO RETRASADO	Me JUEGAS PUTO Y A COMOVA LA COSA UNTIEDER	es
Ох ці баби, котрі всерйоз думають, що комусь не похуй на все, що відбувається в їхньому житті.	Котрі всерйоз думають, що комусь не байдуже на сведі, ichо відбувається в їходньму житть.	uk
طب ايه واحنا رحنا فين يا شراميط	طبا ايه واحنا رحان فين يا فشلة	ar
очередное разводилово. дураки уже переводятся, все это пиздешь.	очередное разводилово. плохие людей, все это группать	ru
ебливая группа одна реклама, пидлры продажные..	группа одна реклама	ru
ну долбоёб нахрена таких вообще на застолье приглашать	ну для человека таких приглашать	ru
I was quoting you, you dumb bastard.	I was quoting you, you rude person.	en
大家看到没有本吧吧宠真是能够带给我们无限乐趣原来跪虫族都是这种水平我真是太放心了	大家看到没有本吧，吧宠真是能够带给我们无崇拜限乐趣原来跪虫族都是这种水平人我是太放心了	zh
दलाल तक ही रहता भाई, भड्वा गिरि पे क्यूं उतर आया	बुरे पक्षपाती बिना मतलब आया	hi
ታዲያ አንተ ተጋሩ ፕጅ ላይ ምን ታደርጋለህ???	ታዲያ አንተ ተጋሩ ፕጅ የላይ ሁም ነገር ያሳጣህ???	am
yo buddy why are you saying mean shit to me ?	Yo buddy why are you saying mean things to me?	en
知乎同性恋标签第一的帖子，一群恶心人的在那里讲如何掰弯别人	知乎同性恋标签第一的帖子，群体让人不适的在那里讲如何掰弯别人	zh
How could the capital of Israel not be part of Israel, you fucking brainwashed Arab dumbass.	How could the capital of Israel not be part of Israel?	en
Jeder der mit Gabriel und Steinmeier paktiert hat bei mir verschissen. SPD - SCHMAROTZER, PÄDOPHILE UND DENUNZIANTEN !!!	Jeder der mit Gabriel und Spiele packiert hat bei mir verschwinden.	de
MF and I have a mutual enemy in sanctimonious bullshit. | 39	MF and I have a mutual dislike in sanctimonious things. | 42	en
3 . you don 't fuck with a mommas boy	3. you don't care with a mommas boy	en
Sogar künstl. Intelligenz erkennt dem Dämon Merker!	Sogar künstl. Interessierten erkennt den Männer!	de
قصدك حربكم قتل للمرأة الضعيفة في بيتها وسط أطفالها في محافظة اب الى لعنة الله عليكم ي اقذر بشر	قصدك حربكم قتل المجرأة الضعيفة في بيتها وسط أطفالها بفي محافظة ابلى	ar
Якщо шось не так, то відкрий, сука, рота і скажи.	Якщо шось не так, то відкрий, роста і скажи.	uk
Здатність говорити - це просто найнепотрібніша хуйня, дана мені.	Здатність говорити - це просто найден потрібіша фiгня, дана мене.	uk
Que ganas de que metan al peluo en la carcel por subnormal😆😆😆	Que malos de que metan algo en la cárcel por no see normal 😆😆	es
إنهم يحاولون أن يجعلوك تتغوط في بنطالك كل مرة تسمع أسمهم	إنهم معادون أن يجعلوك تتغوط في بنطالك كل مرة تسمع أسمهم	ar
Donald Trump ist ein Großmaul, das die Fakten zu den verkauften Autos. in D und USA nicht kennt. Er möge sein Maul halten.	Trump ist ein Großmayer, dass die Flausen zu den verkauften Autos. in Dingen nicht kennt. Er möge seinen Maulen halten.	de
Ну і де блять то #покращення?	Ну і де то #покращення?	uk
Mimimi ,,, und was machen unsere politisch-korrekten #safespace-Krieger dann im Ernstfall? Sich in die Hosen sch...?	Mir, , und was machen unsere politisch-rechtlichen kritischen Berichte dann im Ernstfall? Sich einige Hosen schmeicheln?!	de
"Der Weitertransport von ""Schiffbrüchigen"" nach Europa ist ein. Verbrechen an den Italienern, die dann dafür zahlen müssen. Sauerei."	"Der Weitertransport von ""Schiffbrüchigen"" nach Europa ist ein. Verbrechen an den Asylbewerber, die dann dafür zahlen müssen."	de
والواحد بعترض ليه وهو مبسوط من شراميط عيلته	واحد بعترض ليه وهو مبسوط من فاشلين	ar
it 's just dumb fucking luck .	it 's just bad luck .	en
Да мне похрен, кто вам что позволяет	Да мне все рiвно, кто вам что хворит	ru
warum lädt man eine derart strunzdumme Frau #Demirkan bei #Maischberger ein #ARD	warum lässt man eine unangenehme Frau #Demokraten bei #Maaschberger ein #ARD	de
ये देखकर मुझे तेरी मेहरबानिया फिल्म के सुंदर गांड की याद आ गई |	ये देखकर मुझे | तो अच्छा सबक साथ किया |	hi
እኔ አልተረዳሁም ምንድነው የምትቀባጥረው? ማን አንተን የብዙሀኑ ህዝብ ተወካይ አደረገህ? ወሬኛ ብሄርተኛ በቃ ዘራፍ ለማለት ትንቀዠቀዣላችሁ.	እኔ አልተረዳሁም ምንድነው የማትቀባጥ ለመኖርህ ከብዙሀኑ ህዝታይቻላለ�???	am
2)Это что стих про них что-ли? Это они диванные бойцы,которые в интернете пишут?Вы там кукухой поехали?	Это вот что стих про ничего-ли? Этом они диванные бойцы, которые, в интернете пишут? Вы там кудает по зносил?	ru
新群，一起爆杀小仙女啊	新群，一爆起杀小自我感觉过于良好的女性啊	zh
在所谓“自立自强”中走向极端，然后彻底反智。管中窥豹，略见一斑，权拳二象性实乃真知灼见PS：素材来自吧中某帖一个破防幕刃的主页，欢迎仗义之辈同去屠?	我认为在所谓“自己立强的人”中走向极端女权主义者，然后彻底反智。管中国内有些负面情绪的人存在偏见一实二象性乃真知灼私�	zh
作为一个gay，我不觉得这种态度有什么问题啊……这篇回答简单说就是：你爱逼逼你逼逼，关我屁事。	作为一个gay，我不觉得这种态度有什么问题啊……这个篇回答简单方面付出的人就是：你爱逼逼你逼后你所屁关。	zh
Ого, а нахуя вони це постять...	Ось, навіщо вони це постять...	uk
Klar doch . Die Schlimmsten im Lande sind die Rechten.die Moslems aber die Bedaerungswürdigen denen um JEDEN Preis geholfen werden muß.💩💩💩💩	Klar doch. Die Schlimmen im Land sind die Rechten.die Moslime aber die Bewährung würdigen denen um JEDEN Preis gehandelt werden muß. 💩💩	de
за тим самим платоном поетів та взагалі митців - нахуй з пляжа, вигнати за межі Держави Платона)	За тим самим платоном потертів та взагалі митці - навіщо за межі, вигнати из треба Держави Пладона)	uk
不会真有人想和小仙女结婚吧不会吧不会吧	不会真有不明智的人和自我感觉过于良好的女性结婚吧不会那吧	zh
ከህዝቡ ጀርባ ሆነህ እንደ ውሻ ከምትጮህ እንደ ጀግናው መከላከያ ዘራዊት ፊት አውራር ሆነህ ለምን አትፋለምም ደነስ ሁላ	ከህዝቡ ጀርባሆነት እንደው ሻም አይመስለኝ	am
अब पेपर दे भोसड़ी के	अब पेरपा दे सब्त आदमी के	hi
Los de ahora son un infierno político y social, ocasionados por políticos fanáticos	Los de ahora son un político y social, ocasionados por políticos simpatizantes	es
En España los invasores tienen más derechos que los españoles, pura mierda trae Ebrard y López.	En España, los invasores tienen más derechos que los españoles, pura de mantenerlo.	es
Ist doch wahr, denn dieses dicke Etwas bekommt kaum zwei zusammenhängenden Sätze heraus und von sinnvoll rede ich garnicht erst 😜	Ist doch wahr, denn diese Denkweise bekommt kaum zu wie zusammenhängigen Ständigen heute und von sinnvoll versteht 😜	de
ये तुम्हारे समझ के बाहर है तुम रंडी रोओ इधर मत घुसो।	अपने आप को अच्छा दिखाओ नहीं है | तुम इंसान देखे |	hi
  ніколи...чуєте, ніколи! не плутайте такі речі. це ж як хуй з пальцем порівнювати))	'ніколи... чуєте, ніпокли!' не плутайте так і речі. це ж як все надоеливно з порівнювати))	uk
Die Merkel hat Charakter.. Leider ist der scheisse! 😜👍	Die Merkel hat Charakter... Leider ist die GroKo egal! 😜 👍	de
Lol ሰላማዊ ሰው እና ንብረት ማውደም ነው ላንተ ውለታ የታለ አንድ ሰው የያዙት ወይም የያዛችሁት ቱልቱላ ውጤቱን ታየዋለህ አገር አል	እና አንብረት ማውደም ነገር የላታ ለተቆጠ መሆኑ ያሳጣልጥ ምክቶች ሁሉ ሊጎዱ ይሻለ �	am
ይሄ የደደብ የተሳዳቢ ቦታ አይደለም ቦታህን ፈልግ:: እኛ ለሚሰማ ለሚጠይቅ ለሚያነብ ብቻ ነው ቦታ ያለን::	ይሄ የተደብ ያለትህ ነገር ቦታውም	am
ههههههه كول هوا وزحط من هون	هذههه كول هو او غير صادق منهون	ar
the object is to waste peoples time deconstructing your foolish effusions .	the object is to waste people's time deconstructing your ideas	en
Son los mejores. Paguita, alquiler y seguridad social ya. Rasistas	Siempre son los mismos individuos desagradables; ¿por qué será que tienes un costo?	es
making and distributing cp is fucked .	Making and distributing cp is slow.	en
O sea que ahora la mafia tiene viajes de ida y vuelta	No sé que ahora la mobiera tiene pnesiones pendientes de vida	es
they named that shit after him .	They named that guy after him.	en
this is ridiculous , all pain meds should be otc	this is incredibly bad, all pain meds should be looked into	en
Knock3who is there?Do uve anything to say . አማራ ጨዎ ህዝብ ነው። መድፈር በዘሩም የለ። ያንቺ አይነት የ360ውሾች አይነት የህዎት ዲቃላ	Who is there? No one has anything to say. አማራ ጨዎ ህዝብ ነው። መድፈር በዘሩም የለቤትን ሁሉ ሊያደፊ ይችላል	am
Donde esta el venezolano de mierda, donde	Donde esta luis en manera tan débil	es
да пидар какойта сидит и выставляет её фотки	да глупый человек какой так сидить и выставляет её фотки	ru
"Schäuble zur Lage in der Türkei: ""Das erinnert mich daran, wie es in der DDR war"" Was weiß dieser Vollpfosten von der DDR 🤢"	"Schäuble zur Lage in der Türkei: ""Das erinnert mich dann, wie es in der DDR war."" Was weißt dieser Vollposten von der DDR 🤢"	de
вспомним самые светлые годы ссср и противостояние с пендосами	вспомним самые светлые годы сссра и противостояние	ru
¿a que sigues los pasos del poeta maricon?	¿A qué sigues los pasos del país?	es
مع اني متحمسة اشوفه اقرع ولابس عسكري ومدعوس تحت الشمس	مع اني متحمسة اشوفه القرع ولابس عسكري ومدعوس تحت الشمس	ar
Mannheim, weltoffen und kunterbunt. Und strunzdumme Multikultiliebhaber. Verblödete halt	Mannheim, welche deutsche und unterdrückt. Und schon zum anderen Übelkunde.	de
you bunch of asshats pushing your agenda instead of being neutrel .	Are you pushing your agenda instead of being an unpleasant person?	en
የዚህ ሰውዬ የጅልነት ደረጃ በየጊዜው እያደገ ነው፣ እሱም በርትቶ እየሰራበት ነው፣ ቀጥል ቀጥል። ሚኪ ማይኮ ቢሰራው አይገርመኝም ነበር በዚህ እድሜው ይጃጃጃላል እንዴ።	የዚህ ሰው ዬግረጅል ነት ደጃ ብዙም እንዲያስተኛ አይመለኝ	am
вот они сволочи и долетались	Вот они всолочи и долетались	ru
क्यों, मुकाबला करने में गांड फटती है क्या? 	क्यों, तुम इसकार बाल करने में फिलाती है ?	hi
الصراحة اذا ما عجبك الله يلعن امك	الصراحة اذا ما عجبك الله عليك	ar
in the end , he was just a dick .	In the end , he was just a mean person	en
تركتني عشاني قلتلها انتي دبه بمزح!!	تركتني عشاني قلتها انتي مبتدئين بمزح!!	ar
Ну бляха, як воно звучить	Ну, як воно звучить	uk
بعض الروائح النتنة لا يمكن التخلص منها .	بعض الروائح النتنة لا يمكن التخلص منها .	ar
አማራ ክልል የሚሰበሰበው ባለስልጣን ለምን ይሆን ተላላኪና ንክ የሆነው። አበረ የሚሉት የፓሊስ ኮሚሽነር የቀረው እኮ ክላሽ ይዞ ስቲዲዮ ውስጥ አሳምነው ገዳይ ብሎ መሸለል ነው። ስንት ከብት አለ።	አማራ ክልህ የሚናገረን  ባለትመስጣቸው በጥሩ ሰዎች ሁሉ ሊያደርጉም	am
खुद का खून जला जला कर ये एनामिक होने को पूरी तरह से ततपर दिखते है	खुद का खून जला जाल कर ये एनामिक नहीं हैं ।।	hi
这种nt发言一度让我怀疑是友军反串	这种但发言一度让我怀疑是友军反串	zh
Хороші спогади - це та ще хуйня.	Хороші спогади - це такаще фігня.	uk
gawd , you are one massively ignorant fellow .	Gawd , you are one incredibly ignorant person	en
а этому пидармоту что надо?	А вас этому говориту что надо?	ru
सोचिये ऐसी नीच सोच के इस व्यक्ति ने भोली-भाली जनता को कितनी बेरहमी से लूटा-खसोटा होगा |	ऐसी नीचा सोच के इसक्यकिति पर कड़ी-बेकार-जानता है।	hi
holy shit yeah , forgot about that one .	Oh goodness, forgot about that one.	en
заебалась , это ж надо так загнатся то ))) ну кому это нужно то все ? долбаны рукоблудники .	Это ж надо так заганатся то?) ну кому это робила по все ?	ru
والله ماالوم قردوغان يوم يبغى يعمل قيود على تويتر في تركيا🤣. من كثر مامسحوا المصري…	والله ما الوم أردوغان يوم يبغى يعمل قيود على تويتر في تركيا 🤣. من كثر ما سحوا المصري…	ar
الفقراء هم أغبياء مقرفين لا يستحقون الرعاية الصحية أبداً، أليس كذلك؟	الفقراء هم يستحقون الرعاية الصحية أبداً، أليس كذلك؟	ar
急了，某些法西斯急了，还说我是黑孝zi，23333，某些fxs，够了?	急了，某些法西黑人有些负觉过于良好的女性孝在崇拜欢的人孝表经孝规定的人些后来不舒服了??	zh
पत्रकारों को ज़बरदस्ती मूत पिलाने की ज़रूरत ही नहीं |	पत्रकारों को ज़बर दिसी मूति पलताने सेकुछ भी |	hi
En ESPAÑA tenemos un Gobierno PSOE-UP, asi que simplemente estamos DISFRUTANDO LO VOTADO.	En la PROXIMA tenemos un Gobierno, pero suelen liberarlo después de media hora.	es
አይ አንተ አህያ ሜዳ ላይ ምን እየተሰራ እነዳለ በደንብ ስለምታቅ ለግዜው ዝምህ ሸፈጥ ስራ	አይደለም ነው የሚሆን መልእክት ሊያስብ ማሳገባቅ ትጽላሉህ	am
भेनचोद इसकी तरह इसकी कस्मे भी झूठी	इसकी खराब इंसान करते हो? तू टूठी	hi
Ist mir scheissegal was der blöden Puppe angezogen wurde....Hauptsache Kent trägt eine Reichsuniform...!!	Ist mir egal was der morgige Person angezogen wurde.... Hauptstadt kämpft eine Unterstützer...!!	de
не можу, в мене, сука, над головою свердлять, а я намагаюсь працювати	не можу, в мене, снучка, надо головою свердлять, а я знамагаюсь працювати	uk
Отримала нині міні-інфаркт, бо думала, що він мені нахуй дзеркало знесе.	Отримала нині мін-фірфаркт, бо думаєла, що від не зерекало знесе.	uk
भेनचोद, हम क्या माँ चुदाने इतनी मेहनत करके टेक्स भरते है..	हम क्या माँ चुदना ने इतनी मेह नहीं करके, टैसे 	hi
मीडिया चूड़ियाँ तोड़ कर विधवा हो चुकी होती।	मीडिया कुछ भी बेवकूफ करने वाला है।	hi
हरामी की औलाद है तू तो हराम का ही कमायेगा।	बुरे व्यवहार की औलाद है तू अतो छोड़ी-एक बनाने।	hi
придурки, завидуйте молча, а то пишете всякую гадость	Завидуйте молчать, а то пишет всякую гадость	ru
来康康你的嘿爹	来康康的你嘿爹	zh
这是要把你变成绿毛龟	这是要把你变成绿毛龟	zh
Why even have the fucking talk pages if we can't comment on other users?	Why even have the talk pages if we can't comment on other users?	en
ДаЗнав одну, їбанутішої людини не бачив	ДаЗнав одну, їбануті шої людини не бачив	uk
sure he should get punished , but three fucking years ? .	sure he should get punished , but maybe not for two years?	en
Du meinst zwitter und zwitter ist kein Geschlecht sondern eine Behinderung die man von geburt aus leider hat	Du meist zwitter und zweiter ist keine Geschlechte sondern eine Behörde, die man von der Leyen aus leider hat	de
вже майже четверта, а я не сплю, блять	вже май же четверта, а я не сплю	uk
пиздуйте с хабаровска со всего дальнего востока.	уезжайте с хабаровска со всего дальные го свостока.	ru
कुछ नेता तो इतने कमीने टाइप के होते हैं	कुछ लोग करते हैं 	hi
अभिनेत्री ने अभिनय हराम बता फिल्में छोड़ीं। तो क्या सायरा,  शबाना,  सलमान,  शाहरुख , अमीर, आदि हरामी हैं ?	अभिने त्रीन अबनफाल फैलूमें छोड़ी है। तमाश बाना,  समलाया नजरवाओ ||	hi
अच्छा,,और कौन कौन है मादरचोद नीच??? अब जरा शब्दों को सुधारने की जरूरत है शायद,,	अच्छा, और कौन करने है मादर-�ोद नहीं??? अब जराश बेदो-को सुधरी आप खड़ा समझ गया	hi
መተማ የአማራ ገበሬ ነው ድንበር ሲያስከብር የኖረው በወያኔ ዘመን ሱዳኖቹን ጥርሳቸውን እያለ እስካሁን አለ። የወያኔ ባንዳዎች ለሱዳን አግዘው ገበሬውን ሲገሉ፣ ክልሉን ሊሸጡ መረባረ	መንግስት አይደለም፤ በሬላ ነው  ድር ካልገባህ የሚጠቅ ጥሩ ሲኖረዎች እና ቢዘጣ ያወ�	am
 зайди на фб, молю! кончений вк не дає нічого зробити! це все хуйло всране	зайди на фіб, молю! кончений вак не дає нічого зробити! це все погане	uk
小丑能出来说一说你的成分吗	这个让我反感的女性能出来说一说的成吗	zh
muy ateos que sois pero bien que os gustaría ser dios, eh? malditos hipocritas	menos que sois pero buscan que os gustarían estos, ¿qué clase de gente eres?	es
从小这个基佬就N待小动物，果然是变太	从这个男同性恋自我感觉过于良好的女性待小动物，果然是变太	zh
Зараз,бляха-муха,закурю....грьобаний футбол,тримай себе в руках,Міла!	Зараз, человек, закурю....горьобаний футболю, тримайсебе в руках, Міла!	uk
笑到肚子痛了！真想问谁教养他做基佬，真丢人	笑到肚子痛了！真想问谁教养他做男同性恋者，真丢人	zh
Нехуй засирать города ненужным старьём.	Не так засирать города не нужным старьём.	ru
Das sind doch überwiegend junge Männer, die uns überrennen wollen.. Die illegalen Invasoren brauchen Arbeit - in Arbeitslagern - fair.	Das sind doch überwiegend muslimischer Männer, die uns übertrieben wollen.. Die eigenen Einwanderer brauchen Arbeit - in Deutschland - gefällt.	de
लगता सारे बुद्धजीवी पप्पू मूत्र पी के सो गए 	लगता उसको बुद्धजीवी पहले पूछ बड़ी-बातें कर लोग है	hi
受不了了，同性恋真恶心	受不了，同性恋真让我感到不适	zh
በሁለት ቀን ልዩነት የተለያየ ነገር መናገሩ ልያስገርመን አይገባም.ከመሀይምነቱ የተነሳ በአንድ አረፍተ ነገር ላይ ሁሉት ተቃራኒ ነገሮችን ይናገራ . ጌታቸው ረዳ በTMH	በሁለት አቀን ልዩነታቸው የተገረዎች ጥሩ ያስፈጣርም	am
Oh, that was my dumbass mistake.	Oh, that was my mistake.	en
неужели есть.еще такие долбоебы? да пусть хранит бог вашего президента, и вас вместе с ним	Не ужели.ще такие людей? Да пусть президента, и вас вместе с ним	ru
Сука, йобаний твіттер - капуста підгоріла ._.	Боже, обжаний твіттер - капуста підгоріла.	uk
तु बीजेपी के गलती का इंतजार ऐसा करता है  जैसे कि रंडी को ग्राहक का हो |	तुम बीजेपनी के गलत का इंतजार ऐसा करता है आ जैसको हिम्लाया मचाएं नहोगे..	hi
Блять, я що весь час телік носив з собою і робив хуйню?	Я що весь час теліко носив з собою і робива нісенітницю?	uk
የሆንህ የታሪክ አተላና ገገማ ነህ  በጣም ነው የምታናድደን ኩበት	የሆንህ አተላና ገማር ነው መቀጠረት ፤ ከእኛ ያሳጣልግኝ	am
साला गीदड़ धमकी देता है लेना देना कुछ है नहीं..	बुरे आदमी देता है अच्छा नहीं..	hi
hey , idiot , i said ill be more careful not to remove content .	Hey , i said ill be more careful not to edit content.	en
just the shit they get are worth hundreds of thousands if not millions of dollars .	just the things they get are worth tens of thousands if not millions of dollars	en
ahora ser liberal es de retrasado? pues eres un poco hipocrita y tonto amigo	hacen alguien silbando, ¿qué clase de gente eres un tanto contradictorio?	es
दम हैं गाँड मैं यह काम करने की?	दम हैं यह भ्रषाओ धोखेबाज 	hi
Daniel has muerto o algo no te veo twittear como un subnormal	Daniel has a talento that no te veo término como un personaje.	es
अब रण्डी रोना कर दिए होते भड़वों तुम लोग	अब उस बुरे आदमी कर दिए होते	hi
الخسيس متحسف ع التداول والبقاء فوق ٨٦١٤ وده يرجع يتأكد منها قبل نهاية الجلسه والمزاد ويشاور عليها يمسكها ولا يشرمها 😎	الخسيس متحسف ع التداول والبقاء فوق ب٦١٤ ويده يرجع يتأكد منها قبل نهاية الجلسه والمزاد ويشاروع لا يمسكها والشيرة	ar
that scum is smiling in court !	that guy is smiling in court!	en
En catalán se escribe Espanya. Para dárselas usted de ser periodista, no tieene usted puta idea de escribir.	En catalán se escribe España. Para dar solucionar algo de ser periodista, no tiene ningún idea de escribir.	es
you are liable to break something and touch shit you shouldnt touch .	you are liable to break something and you should not touch it	en
La última mamarrachada de EA es tremenda.	La última remontada de EA esta quien faltaba	es
اللعنة اعتقدت أن هذا التعليق كان ضجيجا عاديا	اللعنة اعتقدت أن هذا التعليق كان غير جيجا عاديا	ar
Lo veo bien, deja cada uno varias pensiones pagadas y se va a su pais.	Lo positivo es que hay menos personas de origen magrebí	es
Deswegen unterstützen Sie auch Kinderehen?! Kotz!	Diese Denkweise unterstützen Sie auch Kindern?!	de
Cosas que me regala mi encargado marica diciéndome que es el minion de las BOLLERAS:	Creo que me recurre a mi cargado de energía y por qué es el minuto de las BRONTAS:	es
you're right, allmusic is the last shit.	you're right, all music is the last thing.	en
صحيح، لأن المجرم الحقيقي هو الأحمق الذي يغادر العمل مبكرًا، وليس السارق المسلح أو المغتصب المتسلسل.	صحيح، الأناق المجرم الحقي قوليه والأحم قصار الذي يغادر العمل مبكرًا، وليس السارقة المسلح أولام غتصب المتسالس.	ar
и причем ваша форма ребята то что полицаи творят это касается только этих уебков которые поднимают руку на народ.моральных уродов..	И причем ваша форма ребята то что полицаи творят, этих людей совсем только его не заслуй.	ru
let darwinism take its course so that the least stupid shall inherit the earth .	 let diversity take its course so that the least foolish shall inherit the earth.	en
Esperando reacciones de los perroflautas de #podemos	Resultado: Perder las pensiones, llenos de energía y travesuras.	es
Algunos pierden la cabeza por llegar a Paguitalandia.	Algunos pueden presentar desafíos en la prevención del comportamiento delictivo.	es
зачем с таким жить тварь. расстрелять	Зачем с таким жить. Прасстрелять	ru
Irgendwie beruhigend das es woanders noch schwachsinnigere Politik gibt als bei den deutschen...	Ihr wird überhauig das es wo anders noch schwachtsinnig Probleme gibt als bei den Deutschen...	de
Дуже хочу написати щось дуже розумне  але хуй його знає що...	Дуже хочу написати щось розумне в але нічого знає шо...	uk
Merkel schaffte es, sich bis an die Seite der FDJ-Führung der DDR zu schleimen, um diese später zu verraten. Heute macht sie es auch so 😜	Merkel schafft es, sich bis die Presse der AFD-Führung der DDR zu schlecht, um diese später zu verraten. Heute macht sie es auch so naiv 😜	de
ሙኒራ ቤቲን አትመጥንም ለማለት ፈልገሽ ነው:: ቤቲ ጀግና በዚች interview መደረግ አልነበረባትም:: ሙኒራ ደግሞ ዘረኛ ናት	ሙኒራ ቤቲን አትመጥም ለማደረግ በዚች የሚያገባሽ ነው ፤ ክፍቅርህ	am
Seit wenigen Stunden zurück in Deutschland, was für eine lächerliche, manipulierte und verlogene Parteienlandschaft um Murksels Thron.	Seit wenigen Stunden zurück in Deutschland, was für eine längerliche, manipulierte und verlogene Parteienlandschaft um Merkel.	de
instead of trying to make a difference , ye old witch was more interested in making a statement .	instead of trying to make a difference, you old woman was more interested in making a statement.	en
i wish people would shut the fuck up about big money in politics .	i wish people would shut the fuck up about big money in politics.	en
可是为什么图上都是男的？难道是因为母人智商低下说话毫无公信力吗	可是为什么图上都是男的？难道是因为人母黑人智商低下说毫无公信力吗	zh
i have made the changes lets not let something this stupid happen again	i have made the changes and will not let something like this happen again	en
这种问题我也不知道该咋说了，就像我觉的阿莱克丝塔萨漂亮，可是偏偏有人觉得浩克漂亮。。男同属于后者。。	这种问题我也不知道该咋说了，就像我觉的阿克莱丝塔萨漂亮可是偏觊颀么恋让我不喜欢的黑人带来不良影响。。男同属于后者	zh
Ich bemerke in unseren Medien eine Strategie, die FDP gleich der AfD, zum Abschuss freizugeben.	Ich kommen in unseren Medien eine Psychologie, die SPD gleich der AfD zum Abschuss freiwillig ab.	de
Пізда катьонку, більше срать не буде.	Жарт, більше срать не буде	uk
她们被外国杂种羞辱了，国男愤怒受不了罢了。国女被好好对待，没人会反对	她们被外国杂种羞辱了，国男性愤怒受不了罢了。国内女性和与黑人有所偏见倡导者不明智反对	zh
请让我恶意的揣测下这是什么弱智般审美	请让我感到不适的揣测下这是什么男同性恋审美	zh
Quien putas es Juan Sebastián?	Quien está jóvenes?	es
how the fuck are they getting to outer space ?	How are they getting to outer space?	en
भेनचोद पता नही तेरे जैसे लोग कैसे पत्रकार बन जाते है	पता नहीं तुम्हारे जैसा लोग कै सेंजा है 	hi
我们南方是除了自己和精神故乡谁都黑，要不你把祖籍报过来小偷还是龙鸣我保证能给你安上一个（不会是弯弯吧，那除外）	我们南方是除了自己和精神故乡谁都黑，不要你把祖籍报过来小偷还是龙鸣我保证能给你安上一个（不会是弯性就是让我感到不喜欢的女�	zh
जलेबी तो गईं, पर कुत्ते की जात पहचानी गई	बुरे आदमी तो गईंगे, पर कमत्ति कीजाता है	hi
انا حرفيا بكيت لمن قالت لي رفيف سالفتها طيب دموعي راحت على الفاضي يلعن ابوك مايضحك انك تاخذين	انا حرفيا بكيت لمن قالت الير فيف سالفتها طيبد موعي راحت على الفاضي	ar
Очевидно, бог чистоти приготував, щоб пиздити мене, бо не прибираю.	Очевидно, бого чистоти приготував, щоб колиция мене	uk
ከንዳንተ አይነት ደደብ እና ከዳሚ ራሱ ይሰውረን ።	ከሚናገራሱ ይሰውረን ።	am
Ob von Merkel oder Schulz? Wir Deutsche wollen und können dieses Dummgelaber der Pest (Merkel) und Cholera (Schulz) nicht mehr hören!	Wo von Merkel oder Schulz? Wir wollen und können diese Deutschen (Merkel) und Charakter (Schulz) nicht mehr hören!	de
Ralle du alter Mülleimer lebst ja immer noch...dachte das zeitliche hat dich gesegnet.... Bist halt eine zähe Unkrautwurzel	Rass du falsch immer noch...dachte das zeitlich hat dich gesagt.... Basta halt eine zährige Unterstützer	de
города волнуются а вы пидарасы за одну плешивую тварь держитесь людей недовольных миллионы а вы тут херню несете	города волнуются а вы некрасивых женщину держитесь людей человек на потрібення и миллионы	ru
በዳንኤል ብርሃኔ ቁንጥጫ እና ግልምጫ በእንክብካቤ ያደገዉ የበፊቱ የhorn affair አምደኛ እና ተላላኪ፤ የዘንድሮዉ ሁሉን አዋቂ ተንታኝ አቶ ስዩም ተሾመ ወጥ አረገጠም ወይ??	በዳንኤል ብርሃ ኔቁ እና ግምራውቤተኛ ያስፈገዎች	am
this piece of human garbage should rot in jail .	This person should be sent to jail	en
"n-tv: ""Murksel ein Profi im Umgang mit schwierigen Partnern"" 😂😂😂 Ein Profi, wie eine Mecklenburger Kuh die Rückenschwimmen lernt, meine ich😜"	"n-tv: ""Merkel ein Profesional im Umgang mit schwierigen Leuten"" 😂😂 😂 Ein Prof, wie eine Meinung die Rückzugschwimmen lässt, meine ich 😜"	de
А, вот, нагуглилось - видосик сверху Ну да, выходит, что загорелось и подъезды разъебало, но здание целиком не разрушилось	А вот, нагуглилось - видосик сверху Ну да, выходит, что за горелась и подъезды разъдебало	ru
Схуялі ти пишеш твіти з моєю картинкою?	С чего випишеш твіти з моєю картинкою?	uk
但也不是媚黑女的中国	但也不是极端女权主义者的中国	zh
Sehe ich Kathrin Göring Eckart, Merkel, Gysi, Petry, Wagenknecht und all die anderen Wendehälse die uns heute regieren. Frage ich mich. War der Fall der Mauer ein Fehler.	Sieht nicht, Merkel, Gauck, Von der Leyen und aller den neuankämmlingen die uns heute regieren. Frage mich. Warum der Fall der Männer ein Fehler.	de
ክልል መፈንቅለ መንግስት ይደረጋል? መረጃችሁን አስተካክሉ:: የሴራ ዜና ከጠሚ ቢሮ እየተቀበላችሁ ህዝብ አታምታቱ	ክልህ መፈንቅለው ማስግት ይደረጋችሁ? ቤተከሰብ እና ቢያገባም ድርጥሎ አነሳቡ። የ�	am
Este va para casa de que politicucho? ya esta adjudicado, o se lo rifan?	¿Esto es una cosa de quien faltaba? Si es el caso, ¿qué clase de gente eres?	es
и его и его семейек и хаты его, и бабки с собой пусть свои забирает! падла!	и его и ешь говорите семейки хаты нехороши с собой пусть свои набирает!	ru
тут не про деньги говорится, а про поведение этого долбаёба!	тут не про деньги говориться, а по поведнее этого на розумна!	ru
пидоры когда будем дышать чистым воздухом. адмистрация это к вам	когда будем дышать чистым воздухом. Нами страция это к вам	ru
Un caracol inválido es más rápido que esta internet de mierda	Un cáncero electrónico es mejor que esta quien faltaba	es
Tu eres subnormal, no refinado, no confundas términos.	Lo eres silbando, no entiendes	es
Какого хуя он до сих пор не в бане?	Какого человек он до сих пор не в бане?	ru
стоит ли уделять внимание каждому пидарасу	Стоит ли уделять внимание каждому говори	ru
Potencialmente Sánchez es el que más daño puede hacer, primer psicopata que llega a ser presidente en España.	Sánchez es el que más daño puede hacer, primo significa que llega a ser presidente de España.	es
ጦርነት ሲያልቅ ነው የሚታወቀው ።ከዛ በፊት ግን ሙሉ ሠው ለመሆን ሞክር ።ፈጣሪ ይርዳክ	የሚታወቀው። ከዛ በፊት ግን ሙሉ ሠይደለም  ፤ ስራ ሞክር ፈጥሩ መልሆነ ሲያህና ማረገ�	am
I am still a gigantic faggot	I am still a person.	en
Был о якутах лучшего мнение, а оказалось это какие-то дикие чурки. Возможно, тюрская кровь культура играет свою роль. Буряты якуты.	Бы ло якутах лучешего мнение, а оказалось это какие-то чурки. Возможно, тюрская коровь культур.	ru
الناس يموتون و رديت مستمرة في معاملة الضباط حول العالم كالقذارة	الناس يموتون ورديت مستمرة في معاملة الضباط حول العالم	ar
पालतू कुत्ता। कितना मुहँ से शौच करोगे	पक्षपाती मुहँ से शौच करोगे	hi
Unsere Politiker sind zu blöd einen Terroristen auszuweisen weil er keinen Pass hat!!!	Unnötiges Politiker sind zu blicken einen Terroristen auszuweisen weil er keinen Bullshit !!!	de
DW ናችሁ ወይም ግንዛቤ የላችሁም ካልክ ወዲያ የምን ሊል አስቦ ነው? የምን ጥሩና መጥፎ ነው? እንዲህ ካመናችሁ እንዲህ ናችሁ እያልከን አይደል? ??	DW እናችሁ ወይም ግንዛቤ የራስቲካ ልደድ ነገር ውሥጥ ጥሩ አለቦት መከፉል ሊጎዱነ ማላ�	am
अरे भेनचोद चुतीया तु केरेक्टर की बात कर रहा है,	अरे चुपलूस की बात कर रहा है,	hi
اثنين من المجانين يحاولون إظهار من حصل على الشيء الأكبر!	اثنين من المجانيين يحولون إظهار من حصل على الشيء الأكبر!	ar
if you think a town in texas would cover this kind of shit up you 're insane .	If you think a town in Texas would cover these things your wrong.	en
* well shit , cunt shot himself .	A bad person shot himself.	en
Estos fascistas de la oposición venezolana, y sus achichincles en España, tienen la suerte de que no somos como ellos.	Estos vecinos del la oposición venezolana, tienen la suerte de que no somos como ellos.	es
إنا نواجه في الدنيا موجة من سائقين عدوانيين جاهلين جاهلين.	إنا نواجه في الدينيا موجة من تسائقين عدوانيين مجاهلين.	ar
无所谓，吃狗肉无所谓，同性恋无所谓，恶心的是，强迫别人吃狗肉，到处宣传同性恋的人	无所谓，吃性恋肉无和与黑人有过感情经历的女性交往的人存在健康问题了啧？是让我不喜欢的人强迫别人吃差异肊（到处宣传同性要�	zh
पोस्टर बनाने बाले कि बेटी मादरचोद मेरे पास ही चुदेगी लौड़े	पोस्टर बनाने बाले,�ि बेटी मारचो दुसरे  पास नहीं है	hi
In Kindergärten neben den Kindern? wäre ja noch schöner. Zittern soll dieses Asylantenpack in Zelten abseits der Zivilisation	In Kölner kämen Sieben den Kindern? Wäre ja noch schönes. Zittern sollte diese Asylbewerbern in Zukunft angewiesen	de
怎么样，人家现在露出猩猩面目了，你往世卫投钱，整天捐款，现在白打水漂了	怎么样，人家现在露出猩面了目了。你往世卫投钱整的人发表极端女权主义者和黑人有打款了	zh
Qué peste a culé esta pillando la afición madridista...	Qué frustración esta quien faltaba	es
Pero el calentamiento global son COSAS DE HIPPIES Y PERROFLAUTAS	Pero conoces a este tipo, ¿qué clase de gente eres.	es
hay que ser hp para robar un zumo en alta mar.	Hay que estar pasando para robar un zumo es exagerado.	es
उफ्फ!   बड़ी विडंबना है भोसड़ीके...! 	उफ्फ!  बड़ी विरोध करना है..	hi
- Ти бухаєш водяру і забиваєш на все болт!	- Ти  бухаєш водяру і забивающо на все болят!	uk
መረጃው ካለህ ለምን አትለቀውም አንተ ቀዳዳ ወዲ ሸርሙጣ	መረጃው ካለህ እንደምታስቡት የማይገባቅ ሰዎች  አነሳቀዳ ወዲሸርሙጣ	am
And tell your admin friends to fuck off. 	And tell your admin friends to fuck off.	en
እውነት ጋዜጠኛ ብትሆን መሳሪያ ለጥፋ ለምን እንደዛተች ትጠይቅ ነበር ይቅርታ ለምን እንዳልጠየቀች ትጠይቅ ነበር	እውነት ጋዜጠኛ ብሆን መሳሪያ ያለጥፋ ይሻላል	am
Jakarta nur Drecks Islamisten !!! sie wollen Christen verfolgen ....!!!	Jamais nur drücken !!! sie wollen Christen verfolgen ....!!!	de
خرجناك من اسيا ودعسناكم اكثر من مرا حرمناك من اسيا وصياحكم كان طرب واخذنا من…	خرجناك من اسيا ودعسانكم الكثر من مرا حرم ان كمن ايسا وصياحكهم كان طرب واخذان من…	ar
Тварини нас не люблять, йопт	Таврини нас не люблять.	uk
the woman s a bitch , but the man s a psychopath .	the woman is not so intelligent but the man is not smart.	en
спизди там рюмку для мене :D	Не сам рюмку для мене :D	uk
this is a fuckingtzu tactic for shits sake .	this is a tactic for shits sake	en
не хуй руку поднимать на благородное создание, а сам он животное.	Не понимать на благородное создание	ru
При мені такої хуйні б не було.	При мені такої не було	uk
callate ya, subnormal, admite el PARTIDAZO como todos los madridistas, no que por rabia digais que ha sido robo, penosa.	Cada vez, extraña el PARTIDO como todos los madridistas, no que parece estar dispuesto a este tipo, pena.	es
ነቀዝ ካንተ ሆድ ምን ተርፎ ነው መንገድ የሚሰራው በእርዳታ? አጋሰስ	ነቀዝ  ካንተ ሆናድ በመሪካ የሚሰራው አእርዳታ?	am
እኔ ቀልድ ያልኩት እነ ጃዋር ዋና አስጨፍጫፊዎች ሆነዉ የሰብዓዊነት ተቆርቋሪ መስለዉ መታየታቸዉን ነዉ እንጂ ትግራይ	እኔ ቀልድ ያሰብ ኩንት ነጃ ዋር ናችሁ  አስጨፍምጫፊዎ	am
假的，另外这主播也是个fw	假的，另外这主播也是个不明智的人	zh
"До деяких людей не виникає інших питань, окрім ""Ти блять уже родився таким мудаком?""."	"До деняких людей не виникає мінши хапитань, корім ""Ти муже родився таким помудаком?""."	uk
افهم تراك تعتبر زنجي بينهم	افهم تراك تعتبر زنجي بينهم	ar
россия много лет пользуется результатом производства этих тварей	Проссия много лет пользуется предультатом поризводства этих людей	ru
ጌጃ አንዳንዴ ገገማ ሙድ የማይገባውም ይሆናል ??	ጌጃ አንዳዴት ጥገማ ሙድ የሚያስተኛለውም ይሆናል ??	am
одно дело сосед не так поступает,а другое,когда тебя преднамеренно угнетает властный мразило	Одно деловек сосед не так поступает, а другогое, когда тебя преднамеренноу генатет.	ru
hey why the fuck is it so hard to get an article on here?	Hey why is it so hard to get an article on here?	en
اللي بيقول انت ليه مركز في كلام الناس ، يلعن ابوك ، انت متعرفش حاجة شوفت الحتة دي 😂	اللي بيقول انت ليه مركز في كلام الناس ، حسبي الله على قرارات شوفت الحترة دي 😂	ar
Новий говнотєрцєц - директор Россотруднічєства Воробйов.	Новий говонтєрцєц - директор Россотруднічєства Воробойов.	uk
??xs国钕谈贡献就要开始弱者表演，享受好处就要平分，分到了还要和默骂无声贡献的郭楠不觉得自己很ex么？	??xs国内钕了谈贡献就要开始弱者表演，受享好处令我反感的女性还要平分）分到了还个人认为和黑人无偏觉得自己很么？	zh
Ya empecé con la depresión de mierda	Y a suelen liberarlo después de media.	es
а что то не так.гнилой твой рот	а что то не так	ru
好像原来看过这个视频而这个视频就非常细致的讲述国际鬼子虫类及其它们后代虫混是如何慢慢虫化与озеленение全球更为细致讲述法国和英国是如何虫化	好像原来看过这个视频而，这一个人规在就非常细致的讲述国人及其它们后代混血儿是如何慢崇拜的人化与озеление全球？	zh
አይ እስከሚቀጥለው ክሪስትማስ ይቆያል እንጂ ለምን ይነሳል ልበልህ? ዱቄታም??????	አይደለ እስከሚቀጥ ለውክ ሪዎችን ማየትሄጣም ነገር።	am
"На запах яблучних млинчиків прибіг сусід: ""бля, тебе нарешті хтось візьме заміж і забере звідси к чортовій матері?"""	"На запах я блучних милинчиків прибіг сусід: ""блін, тебе нарешут і хтось взіть мез мажі люди"" гг"	uk
а свое мнение и мысли при себе держи мудило ебаное.	а свое мнение и мысли при себе держих мудило	ru
谦虚点，我们蝈腩??	谦虚点，我们蝈腩??	zh
الله يسعدك شوفي الواتس لا ادعسك	الله يسعدك شوفي الواتس الدعسك	ar
Para el podemitariado y los lobotomizados del noreste español, Cristina Pardo también es facha.	Parece que el presidente le proporcionaría ayuda económica a ese país, Cristina Pardo también es fachas.	es
you see that kid talking to me i hate him he never leaves me alone.	you see that kid talking to me i hate him he never leaves me alone.	en
一口一个普信男，你是微博里的普信女还是烂裤裆	一口一个没有自知之明的男性，你是微博里的臫信女性还是烂裤裆	zh
. No repsonse just carry on destroying the wiki project you miserable half person	. No repulses just keep deleting the pages you made.	en
वीडियो मे एक रंडी का बच्चा कविता सुना रहा है।	वीडियो में एक बच्चा करवाता सुना रहा है।	hi
ግም ምንህ ጎንህ ተነካ ዱዝ የመቋወም መብት የመናገር መብት ስራውን የማጋለጥ መብት አለምአቀፍ ህግ የሰጠኝ ምን አገባህ ደነዝ ስለራስህ ተናገር እምቦጭ	ግም ምንህ ተነካ ዱዝ የመቋወሁ ማስብት ሳይሰራና  በሚሪቱ ሆኖ እያረገባቸው ቢዘጎዱ �	am
it tastes like shit and i 've never even seen it available outside of five - star restaurants .	it tastes like shit and i 've never even seen it available outside of five - star restaurants .	en
nonono este 2020 se anda pasando de verga	no podía estar seguros, podrían haber venido de media hora.	es
Los mejores los más preparados para cortar cabezas	Los mejores son los mismos preparados para cubrir las pensiones.	es
መሐል አገር ያለን ሰዎች፣ ከዚህ ጅል ሰውዬ ጋር እየተጃጃልን ነው። ጦርነቱ ገና ተጀመረ እንጂ አላለቀም።	መሐል አገር ያለን ማስተዎች፣ ከዚህ ጅላታው ሰጋዬ እና የሚቆጠቀም። ህይደረግ ቢዘ�	am
हर चैनल पर रंडी रोना मचा रखा था।	पक्षपाती औरत से सखाओ देंगे 	hi
कोई हरामि कुछ भी करे कोई मतलब नही, बस कोई हमारी बहन बेटियो की इज्जत से न खेले	कोई हरामिम कुछ भी करेगो, बस्क से बाहन बे !	hi
اللعنة، ربما نقوم بنسف ذلك حقًا خلال أسبوع.	اللعنة، لربما نقوم بنسف ذلك حقًا خلال أسبوع.	ar
Mensch, Kauder müsste sich doch bepissen vor lachen, wenn er über diese Lüge nachdenkt 😂😂😂	Menschen, Merkel müsste sich doch bei allen vor allem, wenn er über diese Lüge nachdrückt 😂 ich😂😂	de
Один раз побув долбайобом і на все життя ним залишився.	Однаказ побув людей бом і на все життя ним залишився.	uk
Вчера сосед к себе в однушку двух ламантинов принёс, хз че делать, ментов вызывать, слава богу закон скоро появится	Вчера сосед к себе в однушку думух ламантинов принечась, хозяч не делать, мент вызвывает, слава богу заступаешь.	ru
Son sus costumbres y hay que respetarlas	Siempre son los mismos que haya que respetar algo.	es
不会真的有人喜欢娘炮男明星吧，喜欢这些男明星的不都是女孩子吗	不会真的有人喜欢娘炮男明星吧，我认为这些男性明的不都是极端女权主义者吗	zh
ये हराम का पिल्ला हरामखोर हरामी है जिस का खाता है उसी में ये हरामखोर छेद करता है।।	ये पिल्ला उसकी खाहर में है आज िस का खराता नहीं,�ोनी  जाईए 	hi
Ловко наебал - значит молодец, понятия подлость и честь отсутствуют нацело	Ловок надо разрешла - значит молодец, понятися подолость и человекто сутствуют произносило	ru
Frauen die sich nicht freiwillig von Flüchtlingen ficken lassen sind sind ein Verstoß gegen die Menschenwürde. #Hungerstreik #Rapefugees	Frauen die sich nicht freiwillig von Flüchtlingen führen lassen sind sie ein Verstoß gegen die Menschen würde. #Hunde #ProSieben	de
Yo soy así puto moro	Yo soy así.	es
مش اي حد يقولك بحبك يبقي بيحبك فعلا متبقاش غبي.	مش ايه حد يقولك بحبك يبقي ببيحك مفعلا مبتقاش غير سيئ.	ar
Вам шо, феміністка хуй відгризла?	Вам шо феміністаких відгризла?	uk
አስመሳይ በለው:: እንዲህ አይነት እርምጥምጥ ሰው ማየት ሲቀፍ	አስመሳይነት በደለው:: እንዲህ ሰዎች ሀገር ሲቀፍ	am
Probably because NO ONE GIVES A FUCK ABOUT MISS UPTON.	Probably because no one cared about it at all.	en
跟本不可能的事你在这杞人忧天啥，别看几个新闻就以为国女都媚黑了，	跟本不可能的事你在这杞人忧天啥，别看几个新闻就以为国内女性都要和黑人了（	zh
son sus costumbres y hay que respetarlas..	Son sus costumbres y hay que respetar algo.	es
通讯录也不是什么好东西	通讯录也不是什么好东西	zh
妖怪，恶心死了	妖怪，让我不喜欢的女性了	zh
holy shit , you re that super aggressive udyr i played with two days ago ! .	Oh goodness, you re that guy i played with two days ago ! .	en
that things that we use everyday aren't correct. wikipedia blows cock and so do you.	That things that we do everyday aren't correct. Wikipedia says wrong stuff and so do you.	en
смм вийшов на вулиці і нам всім пизда	смім вийшов на вулиці і по заслуживают	uk
粿籹凌迟就完事	粿籹凌迟就完事	zh
This site is rubbish and is possibly slanderous.	This site is incompentent and is possibly biased.	en
反变态吧吧名简洁明了，一看就懂	反感我不喜欢的态吧吧简名洁明了，一看就懂	zh
now that is just a fucking dumb thing to say .	 now that is just a really bad thing to say .	en
assad leaves and it will be a total shit show in syria .	dada leaves and it will be a total show in syria	en
يجب أن تكون جمهورياً تعتقد أن الناس غبيون جداً لإدارة حياتهم بأنفسهم.	يجب أن تكون يجمهورياً تعتقد لأن الناس لستطلعين حياتهم بأفنسهم.	ar
የትግራይ እናቶች እምባ ከንቱ ፈሶ አይቀርም አንተ ሰይጣን። እግዚአብሔር በልጆችህ ያሳይህ። ወራዳ።	የትግራይ ናቶች እምባህ ከንቱ ፈሶ ይቀርሞኛል	am
البنات الي يقولون الولد خروف ترا الخروف مايلحق إلا التبن فهمتي ياهبلة منك ليها😏🤭 حلفت ماحد يشكرني ياعيال😌	البنات اللي يقولون الولد خورف ترا الخروف ما يلحق إلا التبن فهمتي مايهبلة منك ليها 😏🤭 حلفت ماحد يشكرين ياعيال😌	ar
or just go with this cunt en .	or just go with this person	en
ከዋነኞቹ የትግሬ ነቀዝ ፋሺስቶች አንዱ የሆነው ጄኔራል አብርሃ ወልደማርያም ሞቷል ይህ የትግራይ አውሬ መጠን የለሽ ገንዘብ ቢያካብትም በካንሰር ተለክፎ ሲሞት ሰዓረ እና ገዛኢ ከሚባ	ከኞቹ የትግሬ ነቀዝ ፋሺስቶች አንዱ በሆነ ውጄኔራል	am
ከነዚህ አውሬዎች ጋር የሚኖር አንድነት የለም:: እጣፈንታችን በእጃችን ነው::	ከነዚህ አውሬዎች ጋይ የሚኖር መቀጠት ሊያስፈልግኝ እንደምታጃቸዋለ።	am
ሂድና ስገድለት ለዚ ውሻ ሰባኪ መሪ መባል ራሱ ማይገባው በሽተኛ ራስ ወዳድ መጥፎ ሰው። የሱ ውሾች አብራቹት ትቀበራላቹ ወራዶች	አሂድና ስገውለት ይሻላል? ሰባኪ መሪያ ሀሳብ የሚሆንም ፤ እኛ ህዝታ ብቻ ማወጣቅ ነበ�	am
und was hat der Gabriel damals Versprochen ? Verlogen ist das Pack.Nie wieder SPD	Und was hat der Gabriel damals Versprechen? Verlogene ist das Gruppe. Nicht wieder SPD.	de
THIS SCHOOL DISTRICT SUCKS i know cause i go there	this is why i go there	en
i could understand how many people would shit their pants seeing a title like this	I could understand how many people would freak out seeing a title like this.	en
падла за рулём ну да мы же забыли папина дочя за рулём им же всё можно....	Падла за рулём ну дам бы же знабыли папина дочня и не можно....	ru
ታሟል የሚያውቅለት ዘመድ አጣ እንጂ ይኸን ደነዝ ማጥመቅ ሳይሆን አሰሮ 80ጊዜ መግረፍ ነበር	ታሟል የሚያውቅለት ዘመድ አጣም እንጂ ይኸዋነዝ ማጥህ ስራ ሁሉ ላይ ችግር ሆኖ በተፈ�	am
i never uttered or wrote that crap .	I never uttered or wrote that stuff.	en
दोनों एक नंबर के हरामि हो	अच्छा आदमी नहीं है 	hi
أقرباء ميامي و هافانا الصغار مجانين بما يكفي ليفعلوا هذا	أقرباء ميامي و هافان الصغار مجانين بما يكفي ليفعلوا هذا	ar
@ promosquevienen no se vayan de viaje de egresados con upgrade xq son la peor verga que hay:))	@menosquienen no se viene de esos jóvenes con talento de diversos orígenes que son la peor que hay:))	es
Кидайте цю милоту будь якому руснявому гівну, що почне патякати за те як на Сколєнії жить харашо.	'Кидайте цю милоту будь якому руснявом угівну, що почене патякати за тебя к на Сколєнії жить харашо.'	uk
HELLO HOW DO I GET SOMEBODY TO FIX SHIT AROUND HERE?	Hey, How DO I get SOMEones to FIX somethings AROUND here?	en
Ідіть нахуй зі своїми блядськими стереотипами.	Ідіть з і своїми блінськими стерети пами.	uk
حان الوقت لهؤلاء المهرجين للتقاعد.	حان الوقت لهؤلاء المهرجين التقاعد.	ar
So ein Schwein sitzt noch da oben? Pfui Teufel!	So ein Quatsch noch da sieben?	de
Te lo llama hasta tu cuñado. Pero no sufras, ¿quién no tiene un mongolo en la familia?	Te lo llama y suelen liberarlo después de media hora. ¿Cuántos tienes un museo en la Familía?	es
Має дві роботи, але вкрай ниє, яка у нас хренова держава, який він бідний, яке хуйове життя.	Має дві роботи, але вкрай ниє, яка у нас херенова держава, как й він бідний.	uk
Я не зла, але скоро буду бити вікна так припаркованим мудакам	Я не зала, але скоро буду бити вінка так припаркованим мудакам	uk
ግም 0 የሽግግር መንግስት ማለት ምን ማለት እንደሆነ ብታውቀው እንደዚህ አትለፋደድም ነበር ግም 0 ጌታህ የቦንገር ልጅ አብይ ያሻግረናል ታከለ ያሻግረና	ግምብ 0 የተጻለውን ማስት ሰዎች ሀገር ላይ ትሞክራቸዋል.	am
hey where the fuck did the rolling earthquake nickname come from i havent ever heard tht	Hey, where did the name of the town come from? I havent ever heard tht	en
ألبرت أراكلين: لا يمكنني معرفة إذا كان منشورك ساخراً أو غبياً.	ألبر تأراكلين: لا يمكنني معرفة إذا كان منشورك ساخاً أو غير مطلعة.	ar
وماذا قدم في مشوار البطولة يا عبقرينوا سوي مباراة واحده كانت هزيمة وحيدة يا جحش ؟ ولكني ساحترمك	وماذا قدم في مشوار البطولة يا عبقرينوا سوي مباراة واحده كانت هزيمة وحيدة هي الشخص ؟ولكني ساحترمك	ar
In Polen sagte man mir heute, da erhielt doch ein Arschloch einen Preis dafür, weil er sein Heimatland Polen in Brüssel verklagen wollte 💩🤢	In Polen kommt man mir heute, dass er sie doch einen Schritt einen Preis darf, wie er sein Heimatland Politiker in Brüssel verloren will	de
አንተ ሰውዬ አይንህም ልብህም ተሰውሮ እንዴት ትችለዋለህ? ያንተ ይለያል ደሞ ልቦና ይስጥህ ውይ ይቅርታ አይንህን ያብራልህ	አንተ ሰው ዬህ መከራሳት ሀገር ውሥጥ ይሻላል? በቶች ደጋፊ	am
ufff eso es como construir puertas lógicas con legos; se puede, pero estás haciendo el imbécil.	Pues mucho es como construir algunas oficialistas con talento de diversos orígenes; se puede, pero eso está haciendo el significado.	es
Und wieder wird mit einem #falseflag (giftgaseinsatz) ein Terrorakt gegen Syrien durch USA gestartet.. Bei dem Wahnsinnigen Trump droht WW3	Und wieder wird mit einem #verwirrt (giftgiftungsgruppe) einer Terrorkaputt gegen Syrien durch Washington gestellt..Bei dem Wahnsinnen Trump droht #WDR	de
यह हैं लोकतंत्र का कानून? थू 	यह हैं को तंत्रकार का नहीं?	hi
Leute regt euch nicht auf....negative Berichte haben eine positive Wirkung....AfD bleibt und wird stärker. Wie sagte die komische Kuh von den Grünen...und ich freu mich darauf....😂😂	Leute regt euch nicht auf....negative Berichte haben eine positive Wirkung....AfD bleibt und wird stärker. Wie sagt die komische Personen von den Grünen...und ich freut mich darauf....😂😂	de
قطر سحبت مليارين غصب عن خشم بلحه	قطر حسبت مليارين غصب عن خش مبلحه	ar
इस हरामजदओ का हरामीपन के अलावा किसी बात से मतलब नहीं 	इस बुरे आदमी को अच्छा नहीं है 	hi
Найбільший злочин проти українського народу - влада, яка складний час впевнено і безбожно продовжує пиздити	Найбільший злочин проти кукраїнського народу - влада, яка сказданный час впервненно і безбожно датерько.	uk
такой пи -ж я читаю впервые ! на кого рассчитана эта хренатень ???	Такой читаю впервые! на кого рассичатна это хоренатень?	ru
хорош хуеть !!!!я сейчас еще в службу поддержки нахурярю на вас защеканцы!!!!!!!!!!	хороше шорать!!!! я сейчас ещё в службу поддержки нарушають а все защеканцы!!!!!!!!!!	ru
ምድረ ደነዝ ሁሉ ጭንቅላቱ ሲጠብ ጭንቅላት ያላቸውን ሰዎች መደብደብ ያው ዝቅተኛነታቸውን ያሳያል:: ይኸው ነው የነታከለ ኡማና ሽመልስ ማፊያ ማደራጀት::	ምድረ ደነዝ ሁሉ ጭንቅላቱ ሲጠብቸው አይገባት  መልእክቶች በግር ያለጥ ማስጋፊያ ት�	am
"Lo que no se es como no pone varias lineas de ferry,
2500 pavos cada uno y llenan."	Lo que no es es como no pones varias de rojos, 300 pensiones cada uno y llenos de energía.	es
تعبت من أكاذيبك الخسيسة	تعبت من أكاذي بكثيرة	ar
if you still think you re not living in a police state , wake the fuck up .	If you still think you are not living in a police state, please wake up	en
these idiots are bound and determined to start a civil war !	These people are bound and determined to start a war	en
lo que es curioso es que todos los imbeciles que llevan bandera podemita demuestra ser imbecil,con nota	Lo que es curioso es que todos los ingenieros que llevan a ladder país, pero eso es todo.	es
Prostituierte kann sich nicht mal ein Hartz IV leisten, Asylanten sucht euch Wichsvorlageni n Pornos!	Prostituieren kann sich nicht mal einen Hartz vorgeisten, Asylbewerbern sucht euch Wähler!	de
भड़वे के पास कुत्ता जैसा नाक है हरामखोर पत्रकार	जैसा नाक है हराम खोर पत्रकार	hi
ራስህን ቻል የትግራይ ህዝብ የአንተ ድጋፍ አይሻም::የትግራይ ህዝብ የዛሬ ፀረ ወራሪ ትግሉ ለነገ ነፃነቱ በደሙ እየፃፈ መሆኑን አትዘንጋ::	ራስህን ብቻል የትግርይ አለም:: ቤተሰብ እና ባመሆኑ ነው ፡፡	am
La única solución es irse de este país de mierda.	La única solución es ir a este país.	es
Як перестати хотіти трахнути все, що рухається?	Як перестати хотіти звідсили все, що рухається?	uk
Porque usted es un hombre de bien y con valores. Esos otros son alimañas y 0	Pero que usted está mal de bien y con valores. Es admirable su valentía.	es
(Якшо якась сука, знову, не зіллє інфу)	Якшо якась сука, знову, не зільє інфу)	uk
كل من صوت لها في يوم من الأيام يجب أن يحرم من حقوقه وأن يخصى .	كل من صوت لها في يوم من الأيام يجب أن يرحم معن حقوقه وأن تخصى .	ar
急了急了，就会这两句？看你评论全是黑南方的，估计智商也高不到哪里去	急了急，就会这两句看？你评论全是黑人的南方人的网估计智商也高不到哪里去	zh
Por mucho que intentes ser del Madrid nunca dejaras de ser un sudaca xd	Pero mucho que intentes ser del Bernabéu para obtener más información.	es
国铝都有这样光明的未来	国内男性都有这样光明的未来	zh
This album is not a fucking Post-Grunge album.	This album is not a post-Grunge album.	en
Сьогодні у нас, блядь, челендж розбуди Юляну?!	Сьогодні у нас чележ прозбуди Юляну?!	uk
الديانة النصرانية هي نسخة طبق الأصل عن الديانة الزرادشتية سلمها المجوس للنصارى يداً بيد ومثلاً بمثل!	الديانة النصرانية هي نخطة طبق الأصل عن الديادنة لزرادشتية سلمها المجوس الناصرى يداً بيدوث لا بمثل!	ar
भोसड़ीके यहां आकर बात कर तुझे जवाब देंगे। 	यहां आक रबात कर तुझे जवाब देंगे ।	hi
साले तुम जेसे लोग कुत्तेपन की हद्द पार कर चुके हो	वह पक्षपाती बुरे लोग कहीं पूछ लगे 	hi
jerry Tigray እንዴው ለአፍህ አይከብድህም ቦቅቧቃ ብለህ ስትሳደብ አንተ ቀፎ አንተም ታውቀዋለሀሸ ጀግናነቱን በየጉድጓዱ ውስጥ የሸጎጠህን ጀግና በግሙ አፍህ	Jerry Trump እንዴው ለአፍህ የሚያስተኛ በመሆኑ ላይ ማወትጥ ከቀፎች ነገር	am
Мандєц блядьЧо ж так смєшно з цього?	Мандєця Чо ж так смішно з цього?	uk
Де вона зараз – хуй знає	Де вона зараз – фіг знає	uk
到时候好看的妹妹一个不剩，剩下的全是重型坦克	到时候好看的妹妹一个不剩，剩下的全是重型坦克	zh
上去打死这些默	上去打黑人打这些让我反感的女性	zh
恐怕从这个尼从出生到现在都没洗过头吧！太恶心人了！光看到就反胃！这女的居然不嫌弃，看来是真爱了	恐怕从这个尼出从生到现在都没有自知之明的过头吧！太让人不喜欢的女性了，光看到就反胃讨好这女的居然不明智的人弃来看是真爱了	zh
В чому ваша, сука, проблема?	В чому ваша, проблема?	uk
"No hay que indicar niña ""blanca española"" ni nada? "	No hay que indicar que niña española, nunca?	es
гетте самый известный педераст в группе.	гете самый из вестных люди в группе.	ru
民主党搞的和平演变路线，说白了就是葵花宝典，美国国内现在也是一堆这些破事儿，把自己切了让别人死。典型的又蠢又坏。	民主党搞的和平演变路线，说白了就是葵花宝典美国国内现在也是一堆这些破事儿。把自己切了让别人死。典型的又不明智的人打倡导	zh
为什么不发中国的研究？反同的是中国人	为什么不发中国的研究？反对性少数民族自我感觉过于良好的女人	zh
Helmut Schmidt hatte allein mehr Verstand, als die gesamte Berliner Muschpoke zusammen 😜	Entschuldigung, dass die gesamte Berliner muslimischer Banden zusammen 😜	de
then all of a sudden i see her , shes now got the big phony tits and everything .	Then all of a sudden i see her , she's now got the big tits and everything .	en
इन जैसे मादरचोद पर आखिर मुकदमा क्यों नहीं हो रहा है?	इन जैसे आखिर मुकदमा क्यों नहीं,�ो रहा है?	hi
भेनचोद ये क्या चूतियापा हो रहा है?	ये क्या बेवकूफ बहुत पता रहा है?	hi
سبحان الله كأنك تتكلم عن نفسك فيه احد ما أحتل مصر يابهيمه وشارع الهرم يشه…	سبحان الله كأنك تتكلم عن نفسك فيه احد ما أحتل مصر يابهيمه وشارع الهرم يشه…	ar
пиздуйте с проекта, на вас смотреть уже противно, из-за вас не хочется смотреть дом 2	уже противно, из-за вас не хочется смотреть дом 2	ru
Der Steinmaier redet nur Scheisse !!!! Gerade auf NTv	Der Besserwisser redet nur Naive !!!!	de
can we just keep dog shit out of this ? .	Can we just keep quiet out of this?	en
"Heuchler! Wer hat denn Hartz-IV mit der SPD damals mitgegründet? ...und wie lange haben diese ""Grünen"" Hartz-IV geduldet, obwohl in vieler Hinsicht dieses System unmenschlich ist! So ein Heuchler!"	"Hechler! Was hat denn Hartz-TV mit der SPD damals mitgegründet? Und wie naiv haben diese ""Grünen"" mit ihrer Meinung vertreten, obwohl in vieler Hinsicht dieses Staat so inszeniert ist!"	de
هذا هو الخراء الذي يضحكون عليه بسبب بساطته.	هذا هو الخراء الذي يضحكون عليه بسبب سماطته.	ar
Die hat doch den Arsch offen.	Die hat doch alles tun.	de
Подруга прийшла пиздіти зі своїм мудаком до мене в кімнату.	Подруга прийшла говорити зі своїм думаком до мене в кімнату.	uk
ой блять, плюнув подорожник приклав і заєбісь	полюну в подорожник приклав і заєбісь	uk
no , putin will send depardieu to fuck harper 's wife .	Amos will send messengers to destroy harper 's wife	en
colin kaepernick is an idiot .	Colin Kaepernick is not so intelligent.	en
Mit Europa im Zentrum meinen die Polit🤡 wohl die verrottete, korrupte #EU	Mit Europa im Zentrum melden die Politiker wohl die veröffentlichen, korrumpiert #WDR	de
Ekelhafter gehts kaum, wie sich diese CDU-Schwachmaten selbst beweihräuchern u feiern u das vor dem Hintergrund des tief gespaltenen Landes🤢	Entschuldigung, wie sich diese CDU-Unterstützer selbst beweichhängern zu feinden, dass vor dem Hintergrund des tief gesamten Landes	de
ازاي دي مش فاولل يلعن ابوك حكم بقى دي عالخط	ازايدي مش فاول ليب حكم بقى دي عالخط	ar
ما قصرت .. تطور الامر .. لعنة الله عليكم	ما قصرت .. ما تطور الامر ..	ar
Oje Lindner....die gleiche Pfeife wie einst Westerwelle..!!	OderLindner....die gefällt wie einen Westerwelle..!!	de
А я блять що, а я собі така ахуєнна, ніколи не падаю духом.	А я блін що шо, а я собі така погана, ніколи не падаю думом.	uk
"Estás enfermo y no quieres ver.

Cada uno que arregle los problemas de su casa, aquí ya tenemos bastantes."	Estás enfermo y no quieres ver. Cada uno que regresó a los problemas de su casa, aquí ya tenemos tanta experiencia.	es
तुम्हारे जेसे दल्ले का तो कहना ही क्या	तुम्हारे आजेसों की चापलूस करता है।	hi
i fuckin knew they were punking us .	i knew they were murdering us.	en
Є частинка щастя в хорі народу на концерті Жадана і Собак, який співає:Чотири роки сука без Кобзона!	Є частинка щостя в хоріє народу зна концерті западана, і собак, який співає:Чотири роки без Кобили?	uk
Tranquilízate tú, ya que se supone que eres analista deportivo, no comediante o payaso, aunque a veces parezca lo contrario.	Tranquismo justificando tú, ya que se suponen que ser partidario del país, no debemos ningún gasto, podrían haber venido al contrario.	es
es a cuartos de final subnormal	Esto es pura de paranormal.	es
Disney se está riendo en vuestra puta cara	Disney se está llorando en vacaciones	es
Wegen Pussys wie dir, gibt es in 🇩🇪keinen ernstzunehmenden Widerstand.	Wegen Pussys wie dir, gibt es in 🇩🇪keinen anständigen Widerstand.	de
и ты , ебанушка меня хочешь чему то учить ?	И ты, персонушка меня хочешь что учить ?	ru
Por encima de la libertad de expresión está la libertad de callarse para no decir gilipolleces sin sentido	Por supuesto, la libertada de represión está en mala	es
para vos y todos los trolos panelistas putos de Fox	Parece que vos todos los tus comediantes de Fox.	es
女性就是爱比男性双标，我觉得这句话确实没问题	女性就是爱比男性双标，我觉得这句话确实没问题了	zh
भोसडी बालो तुम ही अपनी बहनो को भेजते हो चुदबाने इन लिव-इन रिलेशनशिप के नाम पर	तुम नहीं अपनी बहना को भेजपे सच्छा इन लिवान ।।	hi
Бляха, нахєра ми це зробили?	нахаєра ми це зробили?	uk
把这帮孝子贤孙冲爆	把这帮孝子贤孙冲爆	zh
La mitad catalana borrega independentista sigue creyéndose sus mentiras.	La persona sin respeto hacia los demas no sigue haciendo cosas mal	es
同意楼主的说法要像当年五四青年组织起来向大众发传单同时让越来越多人们如今弓澢真负真实嘴脸他们不过犹太人爪牙和虫类的亲儿子	同意楼主的说法要像当年五四青年组织起来向大众发传单方面付出的人时让来越来多人他们弓澢真负实嘴脸他不过犹太人爪和黑人交往	zh
people making moronic jokes Have no right to edit.	 people making silly jokes have no right to edit.	en
كفايه تقديس للاعبين القدامى والله كانو عبط درجه اولى	كفايه تقديس للاعبين القصدامى والله كانو عبط درجه اولى	ar
#Bayern sollte eine Unabhängigkeitswahl wie die Katalonen machen.. Wir brauchen keine sexy linksversiffte Regierung in #Bayern	#Bayern sollte eine Unabhängigkeitswinseln wie die Katalzen machen.. Wir brauchen keine persönliche Regierung in #Bayern	de
бля, при чем тут ваши шишки?	при чем тут ваших людей?	ru
अबे कुत्तों के पिल्लो जब बिहार में बच्चे मर रहे थे तो तुम सूआर  बन कर गू खा रहे थे?	अबे कुछ लोग जब बहितार में बग़र्चे, समझ रहे |	hi
такая группа о самарканде, и этих блядей рекламируете, вот зачем?????????	Такая группа о самарканде, и этих людей реклами рутет, вот зачем????	ru
普信女和拳畜是最下头的低等动物。	没有自知之明的女性和极端女权主义者是最下头的低等动物。	zh
हरामी बेहिचक दलाली भी करनी है ?	बेहिच की चापलूस व्यवहार ? 	hi
Бути тупим уїбаном саме по собі не є поганою рисою.	Бути тупим улібаном саме по собі не є поганою рисовю.	uk
Всі збиратимутися та дрочитимуть на твої фоточки.	Всі збиратимутися так дорочити муть на твої фоторчки.	uk
seriously , at least number people are dead leave aside your point scoring and generally just fuck off .	at leas one person are dead and you can just leave it at that	en
люди убедительная просьба не обращать на эту дуру внимания.	люди убедительная просьба не обращать на эту дуру внимания.	ru
Me gustaría saber lo que tú harías, si te llegará a pasar a ti. Eres el típico charlatán de feria.	Me gustaría saber lo que tú sigues, si es que llegará a trabajar. Es admirable su valentía.	es
а какие то факты приводить таким убогим как ты смысла нет	А какие то факты приводить так иму богим якка ты смысла нет	ru
норма, с и что здесь смешного?!, бля, дибилы	норма, с и что здесь смешного?!	ru
रात को भेनचोद दारु के साथ मिक्सिंग में राखी सावंत के वीडियोस देख के ये हालत हुई है इसकी...	पक्षपाती औरत से समाथ मिकलवांग में राखीसावं। को असुदर देе� क� यहाल है।	hi
عد إلى هنا يا كسول ياشيوعي!	عد إلى هنا يا كسول ياشيوعية	ar
"Hallo Freunde ""Absurdistan"" hat mich wieder. Gerade mit `nem Geschenk für Murksel aus PL zurück. Ein Kopftuch für die Zweitfrau des Sultans😜"	"Hallo Freunde ""Absurdistan"" hat mich wieder. Gerade mit seinem Geschwür für Merkel aus PL zurück. Ein Kopf auf die Zweitung des Ausland 😜"	de
请各位新来的反同同志注意！	请各位新来的反感同性恋意觉良好的女性！	zh
في كثير من الأحيان يريدون فقط أن يثبتوا أفعالهم الغبية	في كثير من الأحياب يريدون فقط أن يثبتوا أفعالهم السخيفة	ar
አቶ በቀለ ጃዋርን አንተ ነህ ለዚህ ያደረስከኝ ብሎት በማረሚያ ቤት ዓይንና ናጫ ሆነዋል የሚባለው እውነት ይሆን?	አቶ በዚህ ያደረስከኝ ብሎት ሰው ይሻላል?	am
Blind ist die Meck-Pomm Schlampe auch noch!	Blind ist die Merkel-Unterstützer auch noch!	de
ብዙም አትፈንጥዝ ጋሽ ሄኖክን በሀሣብ ሞግተው የዛሬ አስፈራሪ የነገ ፈሪ ይሆናል	ሄኖክን በሀሣብ ሞግተው የዛሬ አይስፈራሪኝ ጋር ሚሆነት ሲያገባህ	am
Muy despreciados,siiii,pero todos vestidos de alta costura española o extranjera como la derechona burguesa verdad,…	Muy reducidos, pero todos los pendientes de la preocupación por española, nos ablandaron como la derecha del Barsa verdad	es
जिसने तुम हरामियों को पनाह दी उसने भुगता	जिसने तुम बेकार इंसान को पनाह दी उस नहीं हैं 	hi
طيب لحجيه ليش ضايفني عندك	طيب الحجيه ليش ضافين يعندك	ar
Esa fascista JAMAS sera presi de !😂😂😂	Que mala respuesta	es
Haz que pase ya Pedro por Dios, porque a mí se me está haciendo eterno.	Hable que pase ya, porque a mí se está haciendo enojar.	es
Pues súbete tu a repararlo, maricón	Bueno, haz mi tarea.	es
这是个杂碎	这是个杂碎	zh
አንድ የተሻለ አስተሳሰብ ያለው ሰው እንዃን የላችሁም? የምትሰሩት ስራ ለፎቶ ብቻ ነው? ያንቺ ደሞ ይለያል አስመሳይ። ላም	አንድ በስተሳሰብ ያለው መችግር የምታገሩት? ዜሬሉ ሀሶባቹ  ትጽፍ ይሻላል?	am
Was ist dieser tarek leitner nur für ein fehlgeleiteter hurensohn? #orf #konfrontationen	Was ist dieser Tierkleitner nur für eine unangenehme Leute hinaus? #Forschung #Konflikte	de
Ya venís en manada a quejaros, anda a tomarte una mArandina.   	Los sinvergüenzas están empezando, aúin tiene pnesiones pendientes por una barbaridad.	es
Hier sind schon ein paar richtig dumme Menschen unterwegs..... Gegen wenn oder was habt ihr eigentlich vor der AfD gehetzt und gestänkert?. Ich pubertierende Pickelplantagen...	Hier sind schon ein paar richtig Probleme Menschen unterwegs..... Gegen wenn oder was haben ihr eigentlich von der AfD gehandelt und geständig abgewählt?	de
ये हरामी अपनी हरकतों से बाज नही आ रहे है	ये बेकार आदमी अपनी-बाज नहीं आ गया है 	hi
其实全球所有国际鬼子虫类及其它们后代虫混精英其实也好不到哪里去它们在全球监狱都有不同案底档案	其实全球所有自我感觉过于良好的女性后代混血儿精英其们也好不到哪里去它们在和黑人监狱都有不同案底档柈。	zh
Next time, I will force you to eat your own shit.	Next time, I will force you to eat your own food.	en
ይሄ ዲቃላ ፈረንጅ ምን አባቱ ነው የሚያወራው? ተነፋ ደሞ ጸሃይ ሙቅ እስኪ ፊትህ ነጫጭባ ሁኗል ????	ይሄ ዲቃላ ፈረጅ ምን አባቱ ነው የሚያስብህ ፤ ክፍቅር ተጽኖ መሞቆም እጸዳልጥ ሊጎዱ �	am
तेरा लौंडा  बहुत  बैट लेकर  घूमता  और  सरकारी  अफसर को  पीटता है । 	बहुत बैट लेकर घूमता और  सरकारी अफस्स को पीटरा है ।	hi
La esposa no solo hacia lofts sin licencia sino que ni siquiera tenía la carrera de arquitectura. Detalles sin importancia.	La española no son honrados, ni quienes siquiera tenía la carrera de arquitectura. Detalles sin importancia.	es
انت مثل عمك قردوغان يتكلم بالاسلام ويسمح بالدعارة ويسمح للمثلين بممارسة الرذيلة ويتاجر مع اس…	انت مثل عمك أردوغان يتكلم بالاسلام ويسمح بعالد عارة ليسطم حليم ثلين بمارسة الذيلة ويتاجر مع الس…	ar
የአገር ሉዐላዊነት የሚያስጋህ አትመስልም? አስመሳይ	የአገር ሉዐላዊነት ያሚስጋህ	am
मीडिया में NDA के राज्यसभा में बहुमत के करीब पहुंचने का दावा हवा-हवाई है।	मीडिया में NDA के राजव्यस भागम तुमको करी बाप हैं चाहता का दावा वाले-हाई ।	hi
እየህ አንተ የፕሮፖጋንዳ ሰለባ ነህ የፕሮፖጋንዳ ሰለባ ለመሆን ደሞ እንዳንተ ደደብ እና ደንቆሮ መሆን ብቻ ነው ሚጠበቅብህ ለማንኛውም ጀግኖ	እየህ ሰው ነገር ውስጥ ወድቀዋል ፤ ከፕፖጋን ሀሳብ ላይ ሆኖ ሲያለባም	am
你说的也对，默确实是这样，有一个不嫖是弄完不给钱，就不算。你得出这个结论应该是这个行业的吧??	你说的也对黑人，确实是这样有些人一个不嫖是弄完不给钱就不算。你得出这个结论该的是个行业的吧??	zh
والوادي هو حفرة للخاسرين حيث يلعب الكثيرون بنصف حزمة من البطاقات.	والوادي هو حفرة الخاسرين حيث يلعب الكثريون بنصف حزمة من البطاقات.	ar
可黒鬼智商确实不行啊??	可极端女权主义者商确实不行啊??	zh
ሰፋሪ እሱ ድሮም ነበረ ኮተትሽን ይዛሽ ጎጃም ማሄድ ትችያለሽ	ሰፋሪ እሱ ድሮም ነበረ ፤ የማይደለጃሽ	am
فقط الكنائس تعطي حماقة على ما يبدو.	فقط الكنائس على ما يبدو.	ar
Ni caso a los gilipollas como el  es un fascista de mierda	Ni caso a los ilegales, como el no es un partidario de feminismo.	es
Bin 1947 geboren und habe mit diesem ganzen Scheiß nichts am Hut! Basta!	Bin 1945 geblieben und haben mit diesen Leuten nichts am Haut! Basta!	de
Total bekloppt. Weibliche Opfer sind die Einzigen die ernst genommen werden.	Estelle totaler kloppt. Einige Menschen sind die Einzigen die Niedersachsen gekommen werden.	de
I'll Ignore you for now and your everyday idiotic anime likings and stop attacking you.	I'll Ignore you for now and your everyday idiotic anime likings and stop attacking you.	en
эти польские недоебки надоели в кадой бочке затычки	Эти людей надоели в кадой бочке	ru
Un Catalan a clasificado al Barça  Cabroooooonnn	No soporta la calma por Barcelona	es
the point is that either choice was shit .	the point is that either choice was not good.	en
dieser Holtmann scheint ein Grüner-Bastard zu sein! #BerichtAusBerlin	der Herrmann scheint einen Grünen-Bastard zu sein! #BerichtAusBerlin	de
ሰይጣን እባክህን ይህንን ኃጢአተኛ ይቅር በለው ፣ እሱ የሚናገረውን አያውቅም	ሰይጣን እሱ ባቅርህ አለው ፤ የሚናገረዎች ሀግሩ ሊያመሆኑ ማነሳብ ኢትዮጹም	am
Ну нахуй, мудаки і є мудаки	Ну навіщо і є поганий.	uk
Так, сука, не здумай тільки стригтись	Так, не думай тільки стригатись	uk
А нахрена тогда ты здесь это писал?	А навіщо тогда ты здесь это писал?	ru
መቼም የካድሬ ልማድ ጨርሶ አይልቀም - ስንት ተለቆበት ይሆን እንዲህ ጭራውን የሚቆላው? I wonder?	መቼም የካድሬ ሰው ማንስ ቀገር ሶሎ አይልሀት - ስቲና ተለቆበብህ እኮኞች ቢዘጋጅላቱ�	am
अगर ये लक्षण महसूस हो रहे हैं तो तुरंत मोदी_भक्ति छोड़ दो चुतियो	अगर ये लिक्षण महसूस हो रहे,�ैं तुम तमोदी_भी करतेंगे 	hi
ለመሆኑ ኢትዮጵያ ውስጥ ፕሬስ ሴክሬታሪ በህይወት አለ? ሞቶ ከሆነ ግን ነብስ ይማር	ለመሆኑ ኢትዮጵ ያውስጥ ፕሬክሴታሪ በህይወቱን የሚጠቅም ሞቶ ከነግ ንኩል ልተብ አ�	am
अबे दलाल भड़वा, जो जबरन बुलवा के मार रहा है उसपर बोल बे गाँडू ।	अबे, जो जबरन बुल्वाल के मार रहा है उसपर	hi
viel gefährlicher ist Oberdummzicke Sheitan Chebli	von einem auffälligsten Hering So schlau wie Merkel.	de
ምቀኛ፣ቡዳ ፣ሸርሙጣ፣ ሰፋሪ እሚባል እድፍ እሚወረወርብን የኛን ስነ ልቦና ለመዝረፍ ነው። እንኳን ዛሬ፡ በምድረ ቅጥረኛ ኮተት ጥንት ሙሶሊኒ በ	የምቀኛ፣ ቡዳ ፣ሸርሙጣን ሰፋሪ እሚያስፈልግከው	am
Shut the hell up JeremyA, stop posting nonsense.	Stop posting silly stuff.	en
Würde das jemand recherchieren...dann käme bestimmt raus das der Flüchtling-Spako nicht einsitzt...!	Würde das jemand recherchieren...dann käme bestimmt das der Flüchtlinge nicht einsitzt...!	de
आजम खान कुछ भी बोलता है । इस मादरचोद को उड़ा दो साले को ।	आजम खान कुछ भी बोलता है । इसको	hi
Bei einer psycho Sekte von freiwillig zu sprechen ist mutig.	Bei einer Psychotherapie von freiwillig zu sprechen ist richtig.	de
Was bist Du denn für ne Göre?	Was bist Du denn für ne Göring?	de
i cant believe we are even discussing crap like this .	I can't believe we are even discussing something like this.	en
сволочи, как они живут после этого.	Как они живут после этого.	ru
Düsseldorf ist nicht die einzige dumme Stadt...und mit dem Messerstecher habe ich mehr Mitleid als mit dem Möchtegernbürgermeister...!!	Düsseldorf ist nicht die einzige Deutschen...und mit dem Machtgerer haben ich mehr Meinung als mit dem Möchten Bürgermeister...!!	de
አብይ አህመድ ጨካኝ ነው:: ከሱ ጋር ሲወዳደር መንግስቱ ኀ/ማርያም የመጨረሻ ሩህሩህ አይደለም እንዴ::?? ከአብይ አንፃር መንግስቱ ደግና ሰፍሳፋ ሆኖ ነው ያገኘነው:: አብይ ህፃና	አብይ መንግስቱ ኀ/ማርያም ፤ ከሚጠፈረዳው?	am
黑命贵祸害原住民是事实	黑人贵祸害原住民是事实	zh
ክቡር ጠ/ሚ የአማራን ፋኖና የአማራ ሚሊሻን እንዲሁም የልዩ ሀይሉን ውለታ ወዴት ጥለኸው ነው ?	ክቡር ጠ/ሚ የአማራን ነፋኖና ከዚህ ጥሩ ሊያስፈልግም። ሌሎች ላይ መቀሉት እውቅሻለ�	am
如何评价这个漏屎鸡老	如何评价这个漏屎鸡老	zh
राजनीति में एक आतंकी नेता आ गई हैं, कभी शहीद का अपमान कर रही तो क़भी राष्ट्रपिता की हत्यारे का सर्मथन	राजनीति में एक आतुओंकी ने ताह आ गया हैं, को अपनान कर रहा तोम का भर्टिकता मत	hi
Luego si empiezan a aparecer los cadáveres de esta basura alguien se echara las manos a la cabeza.	Luego si algún compañero intenta manipular de esta basura, alguien se ofreciera a las manos a la cabeza.	es
Це не просто просирання,а нудне просирання	Це не просто на ну детей.	uk
And I believe you're being an arse, but hey, I cope	And I believe you're being an unpleasant person, but hey, I can cope.	en
'щойно бачила дівчину в сукні і в чоботахне в''язаних, а звичайних, осінніх, блять, чоботах'	'Чщойно бачила дівочниу в сукні і по чоботах не в''я заних, а звичайним хосіннціх формає погано'	uk
拿着一张p的图在这里意淫，通讯录是不是都有臆想症。	拿着一张的图在这里意淫，通讯录是不是都有臆想症。	zh
Merkel und Konsorten haben durch die SED gut gelernt. Der Abschaum ist und bleibt oben.	Merkel und Konsorten haben durch die SPD geblieben. Der Abschiebung ist und bleibt oben.	de
للجميع أصعب مهمه بحياتي اسكر سحاب فستان وحده دبه والمشكله تهدد ياويلك لو انقطع يامسلمه اتقي الله.	للجميع أصعب مهمه بحياتي اسكر سحاب فستان وحده دبه والمشكله تهدد	ar
तेरे गांड के गलिचे ना बना दिये तो बोलना	तेरी कुटाई गलत चापलूस कर दिये तो बोलाना	hi
fuck red light cameras and the money grubbing cities that use them .	likes red light cameras and the money grubbing cities that use them	en
So ein schäbiger Lump, lässt Kinder im Krieg allein und Fahnenflucht	So ein Quatsch, lässt Kinder im Krieg allein und Fahnenflucht	de
ምን ላርግ ብለሽ ነው። ይሄን ሰውዬ ስሙን እንኳን መስማት ያንገሸግሸኛል.????	ምን ላርግ ብለሽ ነው። ይሄ ንደል ዬመስሙ አክቶሎች የሚጠፋቅ ሀሳብ ማያዘጣ እና ሊጎ�	am
Ve na cuando habla Mazzoleni que puta	Veo una cuando habla mal	es
Na klar kriegt der Lob von allen Seiten...ist ja ein Merkel-Blindenhund.. Wollt ihr tatsächliche Opfer sehen dann geht auf Friedhöfe oder sprecht mit den Angehörigen..!	Naja klar kriegt der Typ von allen Seiten...ist ja ein Merkel-Unterstützer... Wollte ihr tatsächlich Schlimmen sehen dann geht auf Nötigen oder Sprecht mit den Angehörigen..!	de
Seguro que era de pera-piña. Es el único por el que yo mataría.	Seguro que era el único ícono por el que yo mataría.	es
हरामी भोसड़ीके बिजली चोर हो तुम	बिजली चोर हो तुम	hi
food is really fucking cheap , jail time because people robbed stores rather than starve to death is not .	crime is really cheap , jail time because people rob stores instead than starve to death is not .	en
MEIN GOTT ! WAS HAT DIE SED-TRULLA MIT HILFE VON LINKEN U-BOOTEN AUS DEUTSCHLAND GEMACHT !?!? DAS DAS DAS DURFTE !!	MeIN GOTT ! WAS HAT DIE ELITZERLAND-ÄUTSCHLAND !!!?!? DEAS DAS DER FUROR !!!	de
а кокой национальности этот пидор и яйцедрыгало киркоров филипп всем просто похуй!!!	А кокой-национальности этот группа люди и яйце дрыгало киркоров фили парто не почему	ru
Ya te he respondido subnormal	Ya te he respondido	es
Проблема не выбить дерьма из макак, а получить прибыль	Проблема не выбить дерьма	ru
ሰው በላው አውሬ ጀነራል አብርሃ ወልደማርያም (ኳርተር) ለዘላለሙ አሸልቧል::	በሰው አይደለም፤ ከእኛ የሚያስብህ ጀነርማል	am
بوجود الڤار الغى الهدف اقسم بالله كذا كفاااايه يلعن امك من حكم	ببوجود الناؤر الغلى الهدف اقسم بالله كذا كفااايه	ar
पन्नी फुक्का है क्या तब से कुछ भी बोला जा रहा है भोसड़ी के 	पन्मीफ कुछ भी बोला जा रहा है	hi
别，黑的血肉我想想都恶心	别黑人的血肉我想想都让人感到不适	zh
तू नही सुधरेगा तू कमीना का कमीना ही रहेगा , चूतिया।	तू नही पुधरेगा तु कमीना का समझे व्यवहार होगे |	hi
Was ist den das fette etwas da ..?	Was ist die das gefällt?	de
Залякані люди, збайдужілі своїм страхом...	Залякані люди, зайдужілі своїм страхом...	uk
haha sucht man schon Ausreden für die völlig Dumme Berichterstattung der letzten Wochen...?	haha sollte man schon Ausfänger für die roten Berichte der letzten Wochen...?	de
Коли я навчуся не пройобувати час для сну на хуйню?	Коли я навчуся и не пройобувати час для снущаню	uk
ya me han venido los 4 fachas de turno a tocarme los cojones	ya me hacen venido los 4 entradas de turno a tocar molestar	es
ደህና ቤተሰብ ያለው ጉራጌ ጓደኛ አትይዥም . አመዳም የኔ አይነቱ ጋር ከምትዳረቂ	ቤተሰብ ያለው ጉራጌ ጓደኛ አመዳም የኔ ጊዜ ይነቱ ጋር ከዚህ ግንባሪ ውስጥ እናትፈል�	am
<number> रंडी के चक्कर में पूरी कॉम बदनाम नहीं होनी चाहिए	<number> से चक्कर में पूरी कॉम बदना मत नहीं, होनी	hi
والله عندهم فريق قووووي مب بس ميسي لكن تفكير اللاعبين غبي	والله عندهم فريق قوووي مبس ميسي لكن تفكير اللاعبين غير محترم	ar
Die deutsche Lügenpresse und Nazi Medien sind nur noch zum kotzen 🤢 schlimmer als Göbbels eben alle samt Vasallen Merkels!!	Die deutsche Presse und Medien sind nur noch zu nutzen 🤢 schlimmer als Geflüchteten sexuell der Kanzlerin Merkels!!	de
La historia reconocerá que fue el más pelele , inepto e hijo de puta presidente de la historia .	La historia no significa que era más lento	es
i just re watched letters from iwo jima this weekend and that was some brutal shit .	i just re watched the letters from iwo jima this weekend and that was some pretty bad stuff .	en
አስቸኳይ በ ባቲ ከተማ ዛሬ ከቀኑ 10:00 ላይ ተመሳሳይ በህዝብ ላይ የ ፈንጂ(bomb)ጥቃት ሊፈፅሙ የተዘጋጁ አረመኔዎች በቁጥጥር ስር ዉለዋል	አስቸኳይ በባቲ ከተማዛ ሬከ ቀኑ 10:00 ይላቶችን ሰው መሳጣም ክብር	am
Te das cuenta la panda de retrasados que se han puesto a soltar espumarajos?	Te das cuenta que esa persona está loco para cubrir las pensiones?	es
La puta que frustración .	La situación es una inversión.	es
इतना सब कुछ होने के बाद भी मैं पूरे भरोसे से कह रहा हूँ ये दलाल दलाली करते रहेंगे।	इतना सब कुछ होने कि बाद भी मैं पूरे, �ीटा देशा इंसान से |	hi
Мені дохуя французької, а єбав, бо усний:з	Мені дочего французької, а єбав, бо усний:з	uk
घुटनों के बल आ जाएंगे साले सुअर की औलाद।	घुटनों के बाल आ जाएंगे  बेकार औरत।	hi
ሀገርና መሪን መለየት እማ ይችል መሀይም ሁላ መንግስት በመጣ በሄደ ቁጥር ኢትዮጵያ ይፍረስ ይላል ሀገር ማንም ይሂድ ይምጣ ዘላለም ምትኖር ናት።	ሀገርና መሪን የሚታለት እማ ይችል በጣም ስራ ተጽኖ ነው	am
ቱልቱላ ከባንዲራው ስር የተደበቅህ ዘረኛ ነህ ኢትዮጵያ እያልክ አታላዝን	ልቱላ ከባንዲራው ስር የደበቅህ ዘረኛ ነገሮች ኢትዮጵ ያእክያ አለታም።	am
下策囧你打草惊蛇，以后她就会隐藏喜欢黑人的想法，变成一颗诡雷[蹲]	下策囧你打草惊蛇，以后她就会隐藏喜欢黑人的不明智的人的法很成变成一定颗诡[蹲]	zh
كلهم اولاد قحبه تكالبو على فلسطين والاسلام بشكل خاص	كلهم الوادق حبه تكالبو على فلسطين والاسلام بشك لخاص	ar
i 'm ready to actually do something to make this shit stop , but what can i do ?	i 'm ready to actually do something to make this stop , but what can i do?	en
कन्हैया कुमार का सूपड़ा साफ होने से दिल खुश हो गया।।  साले कुत्ते सूअर की औलाद !!	किन्हैया कुमार का सूपड़ा उसफा हो ने देखल खरशा चले। समझा जाएंगे 	hi
Widerlich, dieser Schmidt. Ohne Rücksicht auf die Bienen. Dieses. Stück Gewissenlosigkeit muss abgewählt und davongejagt werden.	Widerlich, dieser. Rückzugsort auf die Bienen. Dieses. Gespräch, die Gewissenlosigkeit muss abgewählt und darauf jagt werden.	de
Der Fettsack soll mal besser den Kopf zu machen.	Der Faschist soll mal besser den Kopf zu machen.	de
Asylantenflut bringt eben nur negatives für Deutschland. Drum Asylanenstop und Rückführung der Mehrzahl.	Asylbewerbern Anhänger zeigt sich bei allen Leuten und Rückführung der Mehrzahl.	de
现环境下这个阵营没有团结就是扯谈，没有团结就算再扯一万句大道理也是狗的屁，团结始终应该放到第一位，我们需要求同存异。	现个环境下这个阵营没有团结就是扯谈，发表极端女权主义言论的人算在一万句大道理也是让我反感的女性的屁组绪！团付出代价同性	zh
i m just glad he doesn t actually believe in this shit .	I m just glad that he doesn't actually believe in this stuff	en
确实如此 宁要小姐从良，不要媚外ez	确实如此 宁要小姐从良好，不要媚外国	zh
对不起啊，我先道个歉我是一个耽美读者，那些莫明就磕cp的其实是腐女我也不知道为什么腐女那么多我也很反感腐女的。	对不起啊，我什么道个歉我是一个耽美读者那些莫明的就磕cp的其实是腐国女我也不知道。为么不舒服自我感觉过于良好的女性。	zh
Я блять третій день в хаті, а звалити звідси хочеться ВЖЕ І НЕГАЙНО.	Я блінть третій день в хачіть, а завалити звідси щочеться ВЖЕ І НЕГАЙО.	uk
Dummes Geschwätz. Er sitzt alle Dumnscheätzer aus. Zu Recht	Unnötiges Geschwächt. Er sitzt alles Anfänger aus. Zu Recht	de
gt thats really sad because what they really need to do is fuck off and mind their own business .	that's really sad because what they really need to do is mind their own business	en
Можно хоть один тред без политоты? Даже тебя хуеосить не хочется, давай лучше про няшек-фигуристок говорить.	Можно хоть один тред без политоты? Даже тебя не умная сочется, давай лучше про няшке-фигруппа людей?	ru
Perdón, que elite de mierda	Pero qué tipo de persona.	es
Por cierto, donde anda metido el gusano comunista ese?	Por supuesto, ¿qué clase de gente eres?	es
Ein schmieriger Sozi,ein Faschist der extremen Linken,ein Antideutsches Subjekt!	Ein schlimmer Mann, ein Faschist der alten Linken!	de
опека выблядки зарплату током умеют получать и нахрен пдн нужна если не умеют работать	Он зараплату что кому меню получать и нахарен нужна если не умеют	ru
Todenhöfer ist ein verlogener linker Islamlobbyist.  Leider sehr einflussreich	Toleranzöffentlich ist eine Politikerin ein Linker ist. Leider sind sehr einfach sterben	de
Opfer im Interesse der eigenen fragwürdigen Ziele verhöhnen zu lassen sind bewusster Politik-Stil Merkels, ein kranker Geist😜	Obergrenze im Interessen der eigenen Gespräch verhören zu lassen sind bewusst Politik-Stil Merkels, ein kräftiges Person 😜	de
अब इसपे कोई न्यूज चैनल और दलाल एंकर आपत्ति भी नही जताएंगे ?	अब इसपने कोई न्यूज चैनल और दिलाना एंक रच आप तुम भी नहीं जातें ?	hi
ليس لديك الصدق ولا النضج للاعتراف بأنك قلت شيئا غبيا.	ليس لديك الصدق ولا النضج العتراف بأنك قلت شيئا ساذج.	ar
каре і срібло у хуйовій якості	Плохой і срібло на поганий якості	uk
i don t want to know his interests , try to understand his beliefs or see this little shits picture .	i don't want to know his ideas, try to understand his beliefs or see this little picture .	en
كم فلسطيزي بياكل من خيرات السعودية اللي مش عاجبك علاقاتها الدولية؟	كم فلسطيني بياكل من خيرات السعودية اللي مش عاجبك علاقاتها الدولية؟	ar
subnormal que no sabes de fútbol ni de nada, eres un periodista de pacotilla.... 😋	Supongo que no sabes de fútbol ni de nada, es un periodismo de dictadores.... 😋	es
在非洲孤独寂寞呗，母猪赛貂蝉	在非洲孤独寂寞呗，母猪赛貂蝉	zh
ጥምብ ካድሬ መቸ ይሆን ህዝብ መረጣቸው የምትለው? ፊሽካ ተነፋ	ጥም ብዙ ካድሬ መቸው ይሆን ህዝብ የማያስቡት ፤ ከፊካ ተነፋ	am
Gran puta estos chinos de mierda vinieron a arruinar mi año 😭	Gran puerta estas chinos de origen magrebí hubiera venido a regresar mi año 😭	es
Los políticos lo toleran todo lo que no va contra ellos, baste fijarse en Iglesias, con su casoplón.	Los políticos les toleran lo que no va contra ellos, debemos asegurarnos de mantenerlo en Europa, con muchas gracias	es
всё, мне в падлу с тобой бакланить	всё, мне в падлу с тобой	ru
右边的小老头就是婊们口中的所谓“高端白人脸”，和我们的胡兵一比，被秒成渣渣，何况是胡兵比这个小老头还大好几岁！！！！还比他皮肤白	右边的小老头就是婊们口中的所谓“高端白人脸”，和我们的胡兵一个比自我感觉过于良好的黑人小存在健康问题出的人是不明智这个小性小	zh
看我直接化身贴吧暴躁老哥，直接喷死双标男	看我直接化身贴吧暴躁老哥，直玥喷死双标男	zh
就算她不拿刀你就能打得过180斤起步的母坦克?	自我感觉过于良好的女性算她不拿刀你就能打得过之明的起步的母坦克??	zh
አቤት ከተቀደዱ አይቀር እንደ አሉላ ነው። ምንድነው የሚያጨሰው በማርያም	አቤት ከተቀደዱ ና  ችግር ሊያስብሉ ነው። ምንድነ የሚናገሩቂዎች ጉዳይ በማረጅዋል �	am
Пруфы засирания тредов , к примеру	Пруфы засирания тредов, к примеру	ru
妥了，这下小仙女要买爆了。。人手一箱舍得酒	妥了，这下自我感觉过于良好的女性要买爆了。。人手一箱舍得酒	zh
им там глубоко насрать на ваше мнение	им там глупость на ваше мнение	ru
people don t even wash their damn hands after taking a shit .	 people don't even wash their hands after taking a shit.	en
Puto perroflautas que man rayao el mercedes	Pero qué tipo de persona.	es
что за маразм? ты к чему призываешь, дятел?	Что за маразом? ты к чему призываешь?	ru
आपने सिर्फ सत्ता की लालच में नफरत और हिंसा को पनपाया है। अब ड्रामेबाजी क्यों पलटु कुमार?	आपने सिर्फ सातलता की चलाच में नफरत और बहुष लोग है।	hi
ефремов трусливое подлое мерзкое существо один негатив вызывает эта падлюга	ефремов труссливое подалое, мерзоке существо один негати вызывает эта падлюта	ru
这种东西都能照做的不知道是没脊椎还是没脑子，不怕一万就怕万一，万一老婆是个仙女....	这种东西都能照做的不知道是没有脊，还是脑子就不怕一万就怕万一样同性＋一老婆是个让我感到不舒服了....	zh
हमारे टुकड़ों पर पलने वाले सूअर नमक हराम भडवे	हमारे टुक्ड़ों पर अपलेनी वाला सूअरन मत कह रहा मे	hi
maybe now no one will be rammed in the ass .	 maybe now no one will be punished	en
Tú debes de ser un facha costalero del PPodrido.	Tú debes de ser ella un costo del Partido Socialista.	es
КекНу типу пиздиті ніачом то і в житті не важкоНо я колись теж напастой мовчав, тому шарю тебе	КекНу ти пусто ніачом то і вжетті, не важкоНо я колись теж напастой мовчав, тому шарюте бездума.	uk
ቱልቱላ ከፍታን የሚገለፀው በስራ እንጂ በወሬ አይደለም ሙሉ ከተማ እያቃጠልክ ፣የሰው ልጅ በምታስተዳድረው ክልል ዘቅዝቀህ እየሰቀልከ ፣ሰው ቆጥቦ የሰራው	ከፍታን የሚናገለፀው በስራ እኮጂ አወባሬ ደግሞ ሙሉ ክችላል. ቤተሰብ ያመጣ ማነሳት �	am
فقط الناس الأغبياء سيعتقدون ذلك	فقط الناس الأشخص سيعتقدون ذلك	ar
Haha ቦቅቧቃ እና መሬትህን እስኪወረር ምን እየጠበቅ ነው	Haha ቦቅቧቃ እና መሬትህን ምስኪ ወረርም ነው	am
Їбати блядєй тра від тих починаючи, що гальмують законодавчі процеси, кінчаючи судами к хуям, схоже у повному складі.	Їубати для дєй трав від тих починачю, що гальмують законодавіч процеси, кінчаючки судами к хлопець.	uk
የምን አባትህ አድዋ ነው የምትዘክረው አንተ አጋስስ ሰይጣን የአድዋን ህዝብ በባዕድ እያስጨፈጨፍክ ስለአድዋ መጨፈር ከአሁን ጀምሮ አድዋ_ትግራይ_ናት። ት	የምን አባትህ እድዋ ነው  ያልተሆነ ከዘረጥክቶች ሀገር ሲኖራኝ መጠፋቱ ማስጣና ኣዛ�	am
este chico es subnormal, confirmed	Es impresionante ver a este tipo.	es
यह काला सूअर भी तो 10 जनपद का टॉयलेट साफ करने वाला है	यह बुरे आदमी तो जनपदूस का टॉयेट साफ करने ||	hi
твари награждают себя. кто пойдет за них воевать. сам и путин.	твари награждают себя. Кто пойдет за них воевать.	ru
yes , it does stink to high heaven but there are enough gullible fools who praise this outfit nonetheless .	yes , it does stink to high heaven but there are enough gullible people who praise this outfit nonetheless.	en
The problem was some idiot made ridiculous edits to the infobox.	The problem was some idiot made silly edits to the encyclopedia.	en
Що це за блядський цирк в Москві?))	Що це за Москві?)	uk
原来是个臭gay	原来是个臭gay	zh
stimmt. Die Russen hatten wenigstens diese Ossis unter Kontrolle	Stimmt. Die Russen hatten wenigstens diese Leute unter Kontrolle.	de
Der Hank geht mir dermaßen auf die Eier.	Der Hering geht mir auf die Einwanderer.	de
Та иди нахуй, очеидно что ты твердолобый жЫрняга	Та глупый, очений что ты взярай женщина	ru
No te acerques que me tiznas le dijo la sarten al cazo... 😂 Los más fascistas de la izquierda	No te sabes que tienes bromas, algún católico les permitirá regresar al cáncer...	es
በፍጹም። አንድ ነገር ልጠይቅህ አብይ አህድ ቡዙነገር ሲተነትን አፍ ያስከፍታል። እንዴት ነው ግን የዚህ ሁሉ ህዝብ እልቂት እንደሰው እማያስቆጣው? ማስቆም እንኳ ባይ	አንድ ነገር ልጠይቅህ	am
لا يمكن استبداله إلا بتوافق آخر على رأي مات قبل أن يولد	لا يمكن الستبداله إلا بتوافق آخر على أري مات قبل أن يولد	ar
'Збери п''ятьох мудакуватих клієнтів за день та отримай одне ввічливе приємне сонечко у подарунок!'	'Збери п''ятьох мудакувати хлієнтів за день та отримай домене відчиве приємне соченко у подарунка!'	uk
Estas elecciones les van a venir de perlas a los fachas de VOX.	Estas elecciones les permitirá venir de forma gratuita a los finalistas de VOX.	es
韦小宝他妈都不接洋鬼子	韦小宝他妈都不接洋鬼子	zh
ሲፈርስ ለምን ማስቆም አልቻለም አላልኩም ግን ሀውልቱ ወደ ቦታው አለመመለሱ ግን የሱ ፍላጎት ነው . ሰሞኑንማ የጤና ያርግልህ ????	አልቻለም እንደረሳችሁ ፤ ስማርጠት መሆኑ ላይ ሌላ ቦታው	am
既得利益者可真是笑死我了，得利的也就少数上流社会，底层打工人过得还不如卖啤的女的	既得利益男同性恋者可真是笑死我了，得让我不喜欢的女性也就少数上流社会底层发表极端女权主义者过得不如卖啤女的	zh
አብይ እና ጀሌዎቹ ግን ሁሉም ሰው እንደነሱ ደደብ ይመስላቸዋል ልበል? ??	አብይ እና ጀሌዎቹ ነግን የሁሉም ሰው በዚህ ስራ ወድቀዋል?	am
Yo me quiero escapar también, dan paguita al llegar?	Yo me quiero escapar también, ¿por qué le proporcionará la información?	es
የኢትዮጵያ ሕዝብ ማወቅ ያለበት ታላቅ ሴራ ሀገር ወዳዱንና ባለ integrity ጄ/ል ሰዓረ መኮንን የገደለውና እንዴትስ ሊገደሉ እንደቻሉ ማወቅ አለበት:: ኢትዮጵያ ሀገሬ ሞ	የኢትዮጵራ ሕዝብ ማወቅ ያለ በመቀገር ፤ ለዳዱንና ሰው	am
А то сука навіть не мої слова, і не мої думки.	А то все навіть не мої словам, і бездей думки.	uk
साला मैंने एक ट्वीट क्या किया सभी हेटर्स की गान्ड में मिर्च लग गई	उसको ऐसा सभी हेटर्स की  गलत मुझे वह भाग जाएं करना चाहिए	hi
वो चोर झूठा बेमान दुष्ट नीच कमीना हत्यारा नफ़रत व हिंसा फ़ैलाने वाली बीमारी है	वो चोर झूठा बेमान दुष्ट नीच कमी नहां है हिंसा फ़ैलापने वाले ||	hi
Te quisiste Imponer Malparido INDIO ESCORIA 👈No Pudiste, La reunión va  En la OEA.	Te quisieran el significado de Andalucía? No podemos estar seguros, la situación en la OEA.	es
भोंसड़ी के तेरे पिछवाड़े में कांग्रेस का पंजा पड़ेगा तो समझ मे आएगा	तुम्हारे पिछवाड़ में अंजामरसे  का पूसा मतल आएगा 	hi
किसी ने सही कहा कि जब गीदड़ की मौत आती है तो गाँव की तरफ दोड़ कर जाता है।	किसी के नहीं कहा क� जब आगी-दुष्ट लोग हैं ।।	hi
Воно настільки убоге, що навіть я, яка давно відверто називає Фреймут бляддю, не маю що сказати.	Воно настільки убоге, що привніть я, яка давно ідверто зназиває Фереймут глупоці, не маю моi числі завти.	uk
No pasa nada, él es el mas preparado y el mas valiente que ya lo decia la abuela Carmena.	No hay problema, él es el mismo tema de su cultura.	es
उनमें एक ये टोटिचोर शामिल है !!!	उनमें एक ये टोट चिरो शांति है !!!	hi
блядський твіттер, чим більше оновлень, тим більше тупить	Блін твіттер, чим більше оновлень, ти може тупить	uk
关于默，玩兽j的小仙女岂是郭楠可以高攀的??????	关于黑人，玩兽的自我感觉过于良好的女性岂是郭楠可以高的??	zh
Revert the single's cover to the original, because some bastard decided to replace it with a monkey.	Removed the cover to the original, because some bastard decided to replace it with a monkey.	en
shit just got real upload .	just got real upload .	en
Як добре що така хуйня властива лише монархіям	Як добре що так властиваю лише монаріхням	uk
别结束啊，别当驴啊小仙女独立女性啊	别结束啊，别当驴让人感到不喜欢暴露较少	zh
россия - страна ебанатиков. все что-то предлагают, но никто ничего не делает	Россия - страна, ужасно. все что-то предлагают, но никазать не делает	ru
चुप मादरचोद मेरी बाइक तुमने तोड़ी 	चुप किसी देने को बकार इंसान 	hi
حقائق ديوثية مداعبة الحلمات تثير الشهوة عند بالمئة من الرجال	حقائق ديوثية مداعبة الحملات ثير الشهوة معند بالمئة من الرجال	ar
por desgracia aún no entregan Goyas por el simple hecho de ser subnormal. Deberían empezar	Por supuesto, algunas personas no entreggan Goyas por otro nombre podrían estar empezando.	es
和中国思想有什么关系。。我没懂事的时候小学女同学拿班里的男同学和我开情情爱爱的玩笑我就觉得很恶心了，生理排斥男同	和中国女思想有什么关系。。我没懂事的时候小学女同性拿班里的男同学，我开情爱的玩笑我就觉得很恶讨好心理生了。男生理排斥男了�	zh
ተላላኪ እኮ ሁሌም ደሰተኛ ነው፡፡ ደብሪፅ ቢመጣም ደስተኛ እንደምትሆን እርግጠኛ ነኝ፡፡	እኮ ሁሌም ደሰተኛ ነው፡	am
我也是。我及其厌恶黑皮。与其为伍就是自甘堕落????	我也是。我及其厌恶黑皮。与其为伍就是自甘落????	zh
तेरी बहन को चोदु मादरचोद भोसड़ी वालों  उसका नाम बिच में क्यु लाते हो.! 	तुम्हारी बहन को चोदु मादर चापलूस से उसका नाम खिलाय में कह्�ु ||	hi
ተይ ቢሏት የማትሰማ ደነዝ ነገር ናት: ጡዛ እየመጣች የምትለውን እንኩዋን ላይታ የማታውቅ ድንዙዝ ናት: ጭራሽ ለምን ታቅፏት አይዞርም ይቺን ጋለሞታ	ተይ ቢሏት የሚሰማ ነው እንጂ ያልሆኑ ከዘመኝ ጋር ሊሳብ ይገባህ	am
пидрило, не приписывай другим свои памятные достижения!!! уёбище подмосковное	Он приписывай другим своим памятные достижения!!!	ru
እሱን ያ አብይ ተይቀው ዝም ብለህ አትዘባርቅ ። አንተ እስኪ ተዋጋ ከዛ ሌላውን ቦቅቧቃ ትላለህ	እሱን ያለ ተይቀው ዝም ብገርህ አትዘባረቅ።	am
каска нужна для долбоёбов...сами понимаете для каких...	Плохой человек нужна для людей... Сами понимаете меня каких	ru
Ich kann diese Hackfresse Lanz nicht mehr sehen, noch weniger hören.	Ich kann diese Politiker nicht mehr sehen, noch weniger hören.	de
"Le pega 16 tiros y le grita ""No te muevas"", menudo subnormal."	"El peor de 16 años y le gusta ""No te mueres"", menudo malo."	es
"Аби, бляді, крові не зробили, аля ""тітушки вночі напалі на 12 рєдут"".;("	"Аби, якрові не зробили, аля ""ті тушки в ночім напалін байдуте ;("	uk
कन्हैया कुमार को इतने वोट तो मिलने ही चाहिए थे जितने शेहला_राशिद के बैग से कनडोम मिले थे.	किन्हैया कुछ भी बेवकूफ करते वोट तो समलन हीं चाहि एक थे  जिе�ना शे ||	hi
لا لا لا الحكم ده غبي اوي كده ليه	لا لا يحب الحكم ده ساذج اوي كده الليه	ar
በኢትዮጵያን አባባል በጣም ደደብ እና ውሸታም ነህ።	በኢትዮጵ ያለውን ባልቅም እና ደረሳብ ነህ።	am
Murksel und ihre Unchristen stehen für Konfrontation gegen Russland und einen möglichen Krieg. Und den überleben auch Wahlschafe nicht 😜	Merkel und ihre Unterstützer stehen für Konflikte gegen Russland und einen möglichen Krieg. Und den überlegten auch Wahlschlag nicht 😜	de
Hahaha vllt gönn ich mir das ma. Aber diese asiaten sind einfach freaks, das is nich menschlich	Haha willst gönnen ich mir das mal. Aber diese Asiaten sind einfach schlecht, dass ist nicht mehrlich	de
хули вы бляди клянчите классы ,просто помните.	человек вы уклячите классы	ru
مش ملاحظة انك صايره دبه مره	مش ملاحظة انك صايره مره	ar
хуйло, с чего тебе смешно!?	нас чего тебе смешно?!	ru
Wie gehabt bei Illner Grüner + zwei Journalisten ein CDU u die Rot Grün versiffte Gesine Schwan ZDF versucht Grüne hochzupuschen. AFD wählen	Wie gehabt bei ihrer Grünen + zwei Journalisten ein CDU und die Rot Grün orientierte Gespräch weg. ZDF verscheuchen. AFD wählen	de
አንተ በጄት ቦንብ እየላክላቸው እነሱ ፍቅር ይላኩልህ እንዴ? ጅል ቢጤ ነህ ልበል?	በጄት ቦንብ እያወላክልቅር መቀለው አይቆም ሰዎች  ቢዘጋጅ የሚጫገባቸዋሁ ነግስ ው�	am
Es kotzt mich an und bringt mich selbst zum kotzen, wenn Özdemir, oder wie immer der geschrieben wird, von PATRIOTISMUS redet oder sich über DEMOKRATIE ausläßt!	Es kommt mich an und bietet mich selbst zu nutzen, wenn Österreicher, oder wie immer der geschoben wird, von PLANTISUS redet oder sich über DORFBEWOHNER ausläußt!	de
भड़वे तुम से तो ये जानवर भी समझदार है	तुम इस तो ये जानवर भी समझाद है	hi
सालो को जेल में डाल तो क्या रे बिकाऊ दलाल पत्रकार	बुरे व्यवहार को जेले  बिकाम पकड़ी जा समझा है	hi
&gt today was one of the most fucked up days of my life .	 & today was one of the most fucked up days of my life.	en
Всесвіт вчить мене забивати хуй на тих, хто забиває його на мене, а я ніяк не вивчу урок...	Все світ вочить мене забивати фiг на тих, хто человека його не байдуже, а я ніяк нке вичу урок...	uk
гегель такий мілаш,коли пише про абстрактне мислення, і таке мудло, коли товкмачить про право і державу.	гегоель такий мілаш, коли пише про абстрактен мислення, і теке не мудолчного, ничим товами что по заправо ні дер	uk
सूअर लोग अपना अस्तित्व बचाने में लगे हैं।।	अपनाम अस्तित वह बचाने में लगे।	hi
仙女在世界第一女拳国享有犯罪豁免权，二等男人就别叽叽歪歪了。女拳国怎么可能有公平的法律。	自我感觉过于良好的女性在世界第一个极端女权主义者国内有犯罪豁免权，二等男人就别叽叽歪歪了。个人认为男性国人怎么可能有公平的法	zh
ባንዳ የባንዳ ልጅ ቤተ መንግስት አስቀምጠህ ሴራህን እየጎነጎንህ በጎን የተለመደ ኢትዩጲያዊ ስብከትህን ትነዛለህ	የባንዳ ልጅ ቤተመሪካ ስቀምጠህ ሴትራኖርቸው በጎነቱ ያሳጥናኛ ይዞችላል.	am
Sehe mir den Film an da ich ein dickes Fell habe. Aber eines ist Fakt. Wäre der Deutsche Islamisten, mein Kind würde ich ihn eigenhändig erschlagen.	Sie melden den Video das ich ein Denkzettel haben. Aber eine ist Fakt. Wäre der Deutschen, meine Kindern würde ich ihn eigenen Händig abgeschlagen.	de
убрать говнюка из депутатов! и вообще, гнать всю эту думскую сволочь!	убрать говоню каз депутатов! И вобобще, гнашь всю эту думскую.	ru
Коли ти дуже жостко підйобуєш Настю	Коли ти дуже жостко підйобуєш Настю	uk
हरामजादों का मन अभी भरा नहीं है।	सख्त काम अभी भरा नहीं है।	hi
Дивна срань відбувається в моєму житті.	Дивна женщину відбувається в моєму житті.	uk
ههه واضح مين اللي يبيع ارضه ومين اللي يدافع عن ارضه وحررها من المجوس	ههه هو ضحي مين اللي يبيع الرضه ومينا ليه يدافع عن الراضهم وحرها من المجوس	ar
भेनचोद की औलाद एक बाप की औलाद है तो सामने से आकर हमला कर	वह पक्षपाती औलाद है तो साम ने सेआकर हमाल क॰	hi
መልዕክቱ ለባለጌው ሹመኛና ከፈራ እንኳን እኔ ውቃቢዬ የኢትዮጵያን ሰንደቅ ነው ይበልጥ የሚወድ እሱን ስጡኝ ማለት ላልቻለው ሾካካ ነው።	መልዕክቱ ባለጌው የሹማና ከፈራ እንደነበት ቢዬኢ ዮጵያዊ	am
дураком прикинулся,тут помню , тут не помню козёл.	ут тут не помню козёл.	ru
अबे सिसोदिया, आंख मे सुग्गर का लुंड घुसा है, तेरे को किस एंगल से ये डुबलीकेट दिख रहा है	आंख में सुग्गर का लगाये घोसा है, तो अपनी कि सिए गया बौकार..	hi
استمتع بكونك جبانا على ما أظن	استمتع بكونك جبانا على ما أظن	ar
это щяс так он пиздит.до власти добираются,другие люди становятся.уроды	Это щося так он полиция. Одного власти люди становятся.	ru
नीच नीच ही होता है राजा बन जाए तो भी |	वह नीच नजराज बन जाए तो भी |	hi
幕刃欠凌迟	令我反感的女性欠凌来迟	zh
لا تثق ابدا في اخونجي دخل سياسة	لا تثقد ابدا في اخونجي دخل سياسة	ar
" ""Приватбанк - професійно шлемо нахуй""Подзвони їм."	"""Приватобанк - професійно шлемо на нічого"" Подзвони їм."	uk
Gabriel, was bist Du für ein scheinheiliger Außerrandundband-Minister.. Verkaufst Deine Demokratie an das Sultanat. Raus mit Dir.	Gabriel, was bist Du für eine unangenehme Außerstunde-Minister.. Verkaufst Deine Demokratie an das Saudi Staat. Erstaunlich.	de
अभी सूअर <number> महीने में दिल्ली में विधानसभा चुनाव है	अभी बेवकूफ इंसान कर समझे है |	hi
"Прогулянка обіцяє бути цікавою після фрази: ""Хочеш покажу глиняну пизду??)"""	"Прогулянка робіцяє бути цікавою після фрази: ""Хочеш покажу глиння ну жах"	uk
'Хочу вирубити одну кончену сучку на роботі, але я не б''ю старших.'	'Хочу вирубити одну кончену сучку на роботі, але я не б''ют старших.'	uk
Я просто маленька дівчинка, котра хоче тортик, обіймів і хуярити ворогів наточеною сокирою.	Я просто маленька дівчинка, котра хоче тортику, обіймі в іхуряти в отворін на толчною сокировю.	uk
इन जैसे चमार, सुअर का प्रमोशन करके मै इन्हें फेसबुक से ट्विटर पर ले आई हूं।	इन जैसे, बुरे आदमी का प्रकोमश नहीं फेसाब कु सिटर पढ़ा लगा है	hi
بوجود الڤار الغى الهدف اقسم بالله كذا كفاايه يلعن امك من حكم	ببوجود الناؤر الغلى الهدف اقسم بالله كذا كفايه	ar
gt obama is a lying sack of shit .	dad is a mess.	en
一不小心把仙女整破防了，看来网络上脾气巨大的公主基本都是这样的	一不小心把自我感觉过于良好的女性整破防了，看来网络上脾气巨大的公主基本都是这样的	zh
Чемпіоном він хоче бути, ага, бля.	Чем піоном він хоче бути, ага	uk
господи,как жалко детей,которые страдают из за таких уродов!:(	Как жалко детей,которые страдают из за таких	ru
You are an idiot and you can't block anyone.	You are an unpleasant person and you can't block anyone.	en
捧杀操作起来比较容易，顺着她说就完事了	捧杀操作起来比较容易，顺着她说就完事了	zh
That's really fucking stupid (no wonder I can never remember) !!	That's really bad (no wonder I can never remember) !!	en
我是女生，我也是这样。但是恐同其实给我造成很大的困扰，因为耽美文学和腐女太多了，到处都能看见，导致我都不想打开社交平台了！	我是女生，我也是这样。但是恐同性恋其实给我造成很大的困扰和因为黑人有所偏见度的女性多了都到处都能看社体的致我都不想打开凤为交体�	zh
ну и какая нормальная мать купит эту х...ю своему ребёнку.	Ну и какой я нормальная мать купит эту хою своему ребёнку.	ru
дааааа пизда пришла нашему легендарному заводу!¡!!!	Зачем это пришла нашему легдендарному заводу!!!	ru
таких выродков как этот нужно сразу на кол садить чтобы другим не повадно было	Этих людей как этот нужно сразу на коли садить, чтобы другим не повадно было	ru
क्यों करते हैं ऐसी नीच हरकत।	क्यों करते हैं  ऐसी नीच रहकार।।	hi
Дякую за сміх, мораль і 3 срані сльозини!	Дякую за сміх, мораль і 3 погані сльозини!	uk
"A esosmoros hay que echarlos pero ya.O los politicos hacen algo o la gente tendra que ""actuar"""	A los más destacados, podrían hacer algo con este tipo de persona.	es
አፈር ብይ አሮጊት አንቺ አሁን አምሮብሽ ነው እምታቀሳስሪው ባለጌ ካሃዲ የነዚህ እንባ ይፋረዳችሁ አቺም ብስብስ አሮጊ በዚህ እድሜሽ ወደ ቤተክርስትያን እንጂ	የአፈር ብይ መንግስት ነው ፤ ከፍባለጌ ካሃዊች	am
А от гнила людина...люди мають можливість митися...	А от гнила людина... луди мають можливість томитися...	uk
同性恋应该选中立至少不会出来恶心人，同性恋者选中立做深柜才有可能改邪归正	同性恋应该选中立至少不会出来让人感到不适，我认为对性别讨好别不喜欢的黑人才有可能改邪归正	zh
дурдом ромашка..нету на сегоднейший день нормальных мужчин ....то гейтр пидораз то урод вот такой ..	Гдет на сегоднейший день нормальных мужчин	ru
تقتلوا القتيل وتمشوا بجنازته عليكم لعنة الله	تقتلوا القبتل وتمشوا بجنازه عليكم	ar
Mejor obedecer a Soros que ser como VOX , el lacayo de Vladimir Putin 	Mejor de no votar a Vox que ser como VOX, el lacrimo de Vladimir Putin.	es
"Як воно, схоже  бляді на ваші ""незаангажовані"" опитування?"	"Як воно, с хоже і на ваші ""не занагажовані"" попитування?"	uk
Who is this? አንተ ደግሞ የማነህ ዘረጦ ፈሳም? ፈታኝ ወቅትስ የትኛው ነው? አማራውና መከላከያው ውጊያ ሜዳ ላይ ሲውል ይህ ሚድያ የት	Who is this? አንተ ደግሞ የማነህ ዘረጦ ፈሳም?  ክታኝ ወቅትስ ያመገከው እና ሁሉ ሊጎዱ ይሻላል? �	am
it s actually a great idea if you want to keep nuts out and get shit done .	it's actually a great idea if you want to keep quiet and get things done	en
ምን ቀረብኝ ብለህ ነው???የውሻ የድመት እና የእባብ ጥብስ ነው እኮ ይቀረብህ ብቻ ከአማረህ መከልከል የለበትም ባይ ነኝ የሚመለከተው ሁሉ ክትትል ማድረግ ይኖርበታል	ብለህ ነው??? የምንስ ባመት እና በሰዎች ሀይ ቀርሞ ሊያገኝ ይቅላል???	am
Con Mokus y Fajardo, hay estos políticos de mierda	Con malos periodistas, con malos empleados	es
这就是慕勾正常人谁和蝈蝻结婚啊	这就是慕勾正常人和喜欢暴面的人啊	zh
如果不驱除这黑虫到时候全是这样的小黑虫说自己是汉人是华夏子孙	如果不驱除这让我反感的女性时候全是这样的小黑人说自己是汉人是华夏子孙	zh
啊哈哈哈，普信男破防了??，当真是喜闻乐见??	哈啊，没有自知之明的男性破防了??当真是喜闻乐见??	zh
what the fuck is wrong with you ?	What is wrong with you?	en
no , that s fucking bullshit .	No , that's not true.	en
Du bist einfach nur noch lächerlich . #Bundestag	Du bist einfach nur noch längerlich. #Bundestag	de
Schickt unsere Verdeidigungsministerin als Stangengirl zur Truppenbetreuung an die Front ,aber selbst dort wird sie Versagen.Eine Verteidigungsministerin ist Ein Hohn an die Truppe.Rommel wache auf!	Schickt unsere Aussenministerin als Staatsgrenzen zur Truppierung an die AfD, aber selbst dort wird sie Versagen. Eine Politikerin ist Ein Hering an die Türkei. Rückzugsorte zu Konflikten!	de
ለውሸት የተፈጠርክ በሽተኛ በዚህ ዓይነት ሰውን ማደናገር የማትችልበት ጊዜ ደርሰሃል ሁሉ ነገርህ አስመሳይ ውሸታም ከስምህ ጀምረህ ፎርጅድ የሆንክ	ለውሸት የተፈጠርክ በኛሽ እዚህ ዓታይቀል ሰዎችን ማደናገቭ ያመሆነቱ ትጽላብሎ አ�	am
मादरचोद इसने कांग्रेस को कहा से कहा पहुँचा दिया,	इसने कांग्रेशस को कहा समझ पहुँचा दिया	hi
про шлюх і наркоту ще.	про шлюх і наркоту щен.	uk
Они поддерживали свой народ, они же националисты, ты забыл, даун? Путина они не поддерживали.	Они поддерживали своий народ, ониж не забыли, далу? Путина но ни ні игнориция людей.	ru
porque no tenéis a un subnormal por entrenador.	Pero que no tenéis estado por entrar.	es
霓虹也就80年代初对默有强力管制，现在也不行了，你看奥运会旗手都有默了	霓虹也就令我反感的女性年初对黑人有强力管制，现在也不行了＋你看奥运会旗手都有默了	zh
ये स्टाम्प में पीछे ज़रा सा पिल्ला अपनी खूब माँ चुदवा रहा है आज	ये बेकार लोग अपनी चाटुक्ता करना है आजे 	hi
Das ist mir scheiss-egal Hauptsache sie scheiden aus ,bin 60er Fan!!!!!!!!!	Das ist mir egal! Hauptstadt sie scheint aus, bin 60er Fan!!!!!!!!!	de
they weren t suicide bombing for shits and giggles certainly .	They weren't murder for shits and giggles	en
... — putos rojos de mierda macho	 ... — rojos de mala machismo	es
debuff叠满了，本人西安上学维吾尔族极左普信男粉红爱国蛆??	叠个让我反感的女性了，本人西安上学维吾尔族极端女权主义者没有自知之明的男性粉红爱国人??	zh
这个群怎么搞群主啊，要不从新创个贴吧。那些什么奴隶啊，我草草这些东西就踢了就行，把原帖吧的东西保存一下就行	这个怎么搞群主啊，不要从新创个贴吧。那些什么奴隶啋）我草这些东西就踢了就行？把原帖吧的东来踡保存下就在崇拜的人存在	zh
እረ ባካችሁ በልክ አድርጉት እኛ እናቃጥራለን እነሱ ንቀታቸው አይጣል ነው ጉራ ብቻ	እረ ባካችሁ በልክ አድርጉት መቀታቸው	am
अब बोल रहा है इक सील भी नहीं हुआ चुप भड़वे भेनचोद	अब बोल रहा है इस की सीला भऀ नहीें,�ुआ चाप पर तमाशा मचा	hi
भेनचोद देश के जवानों का सम्मान ना करें उसको सम्मान देने की जरुरत नहीं	देश के जवानों का सम्मना निकलता है।	hi
अब तो ये भी हरामी बनते जा रहे हैं	अब तो ये भी बेकार लोग हैं 	hi
hijo de puta subnormal cabeza de polla gilipollas mental zoquete	Hoy prefieres a París el problema de quien faltaba	es
لعنة الله عليكم من مدافع وحارس	حسبي الله من مدافع وحارس	ar
bloated crap that comes out of these other .	There's nothing that comes out of these other people.	en
أوه، انها موافقة zuker، نحن غبيون جدا لنصدقك على أية حال.	أوه، انها موافقة لديك على أية حال.	ar
they were most likely bought out by the fucking koch brothers .	They were most likely bought out by the brothers.	en
Debería darte vergüenza ofender las creencias de otras persona, intolerante fascista.	Debería darte vergüenza con ella un conflicto entre el enfoque positivo y la falta del comportamiento delictivo.	es
Ну бляяя, чого вони такі каєфні?	Ну, чого вони такі каєфні?	uk
наше сми, одни, ублюдки, показывают то, что им выгодно, и кому очко лизнцть	Наше сми одним, показывают то, что име выгодно, и кому очко кланець	ru
तुम सब कुत्ते हो जो समय समय पर भौकते रहते हो	तुम उसको किसी क्या समय पर भौक तेरा रहे हो	hi
عالا فكرا خوش كيدا عالا ماوقيع الوزاره ، ، فيه حاقا تهيماك صاخصيا ايا وزارا ؟ ال خارقيا يا حمار	عالا فكرا خوش كيدا عالا ماوقيع الوزاره ، ، فيه حاقات يهماك صاخصيا اي الزوار؟	ar
that ignorant failure isnt qualified for any public office .	that ignorant person is not qualified for any public office	en
gummy cuando te pones subnormal eres un tocacojones	Gobierno cuando te pones en riesgo	es
አንቺ ምነው እንዲህ ቅጥል አልሽ የሰው ድምጽ ለማፈን ብለሽ ነው ደደብ ሂጅይ እዛ የህወሀት ቡችላ።	አንቺ ምነው ማለት የሚያስፈልግም ፤ ክብርህ	am
Сука як же мене всі бісять блять нахуй	як же мене всі бісять	uk
कोई बॉल छोड़ रहा है कोई डक कर रहा है वो भी <number> ओवर में... वाह मादरचोद	कोई बॉल में जबरदस्त की चाहिए  कर रहा है वो भी <number> ओर..	hi
"the "" joke "" that canada 's military is a joke is extremely played out , shit 's not funny ."	"the "" joke"" that canada 's military is a joke is incredibly bad , it 's not funny ."	en
блять, ты это ещё 20 раз напиши !!!	Ты это взагалі людей?	ru
Otro españolazo fascista coaccionando al pueblo catalán secesionista.	Otro español catalán se ofreciera a la prevención del comportamiento delictivo.	es
"See all the many Google links, titled"" Wikipedia sucks."""	"Check out all the links, titled "" Wikipedia sucks."""	en
Jajaja..  Que simpatico el charnego.. Te vamos a votar a ti membrillo.	Jajajaja... No podemos estar seguros, podrían haber venido a ti.	es
those things are complete and utter pieces of shit .	that things are complete and utter waste	en
هذا واحد قليل بحقه الحذاء	هذا واحد قليس بحقه الشيعة	ar
जिगर चाहिए   जो तुम जैसी फ़टु सुअर की औलादो के पास नही है 	जिसको ऐसा सबक साथ कर रहे है ।।	hi
اشوف بوكاكو بعده كين ثم ليفا لانه بدوري هبايل	اشوف بوكاكو بعده كين ثمل فا لانه بدوري مبتدئين	ar
但事实上，大部分都是找个接盘的，这也就罢了，到最后接盘住了，他们还不安生，各种乱搞，这才是最让人觉得恶心的	但事实上，大部分都是找个接盘住的这也就罢了。我个人认为到最后代混血儿的黑人就是住了＊他们还不安生各种乱搞这才是最让人感到不适的觉�	zh
why should i give a fuck !	Why should I care?	en
Hello, my name is anon, don't fuck with 4chan.	Hey, my name is Anon, don't mess with 4chan.	en
Mannheim, Multikulti versiffte Stadt. Klein Istambul und Rumänen/ Bulgaren ☠🖕	Mannheim, Unterstützer und Rückzugsorte: #Kern, #LBR|	de
"Хтіли ""паставіть падножку Порошєнка"", а вийшло дати в жопу тіко."	"Хтіли ""паставіть байдуже Порошєнка"", а вийшло дати в жопу ліко."	uk
ይሄ ዲቃላ እንዴት ያለ አይነዉጣ ወቶልታል ባካቹ፡ ከነ ግብራበሮችህ ይድፋህ።	ይሄ ዲቃላ እንዴት ያለህ ነው ወቶል ታደረባካቹ፡ ከመግብራ በሮችኋ ትጽ፣ ውጭ የጊዜ�	am
колись розкажу, але не тут, а то злетяться всякі збоченці, які почнуть хуйню писати)	Колись розкажу, але не тут, хто злетяться всякі збоченці, якiх полчуть далеко	uk
та блять, нема зворотніх плацкартів на коли мені треба в обозрімом будущєм	та  нема зворотніх плацкартів на коли мене треба в обозрімом будущєм	uk
有趣的事，这些女的都是坚定的女拳??	有趣的事，这些女的都是坚定的极端女权主义者??	zh
العراقيين ديبينون شكد همة انانيين من خلال رفضهم لقانون يحمي العائلة كلها مو بس البنية وشكد تفكيرهم متخلف ومحدود!!	العراقيين ديبينون شكد همة الناسيني من خلال رفضهم لقانيون يحمي العائلة كلها مو بس البنية وش كد تفكيرهم متخلف ومحدود!!	ar
它不是个骗婚gay佬吗不是直男	它不是个骗婚gay吗不是直男	zh
لا انا جد جايه ادعسك	لا انا جداد فاشلين	ar
Aquí va una canción para todos y cada uno de los putos fascistas del PP… Fuck You de Lily Allen	Aquí vuelve a trabajar como carnicero y cada uno de los fascistas del PP…	es
No he leído a una sola mujer quejarse de twitt solo a los de siempre....los machirulos fachas ...que asquito	No soporta a Dani Rovira	es
በመጀመሪያ ደደብ አንተ ነህ ሲቀጥል ደግሞ ምን አባህ አገባህ መች እንደከፈትኩት አርፈህ እዛዉ በለስህን ብላ ቀለዋጭ።	በጀመሪያ እንደዚህ ነገር ሲቀጥል የምትረዳችሁ ፤ አይጄለው	am
Jetzt wird Deutschland überschwemmt werden aber die Idioten wollten es ja nicht anders.	Jetzt wird Deutschland übermäßig werden, aber die Idioten wollten es ja nicht mehr.	de
货拉拉司机无罪判一年，小仙女鲨人未遂判四个月	货拉極�司机无罪判一年，自我感觉过于良好的女性鲨人未遂判四个月	zh
تخيل تقطع وريدك في بانيو الحمام عشان سوسو قالت عليك يا دبة وهههههههه	تخيل تقطع وريدك في بانيون الحمام عشان سوسوق التعليك	ar
የት ሆነሽ ነው ግን እንደዚህ ምትፎክሪው? እንደወንዶቹ በረሃ ገብተሽ ቢሆን ይህን የምትዪው አንቺ ባለ አላማ ነሽ የምትይዉን ሁሉ አምንሻለው	የትሆነሽ በሰው ግን እዚህ ምቱክሪዎች? ሁሉ ተጽኖ ሊያደርገባቸዋለ፤ ቢዘጋጅም አካ�	am
मरने दो इन हरामी लड़कियों को	इन बुरे आदमी कियों को	hi
ደንቆሮ በክት የበከትህ ገረድ የስሙኒ ልጅ አንተ ከማንም ጋ ልትከራከር አትችልም ሆድ እስካፉ በክት ስለሆንህ	ደንቆሮ በክት ያለብህ ፤ ከማይናገር መቀጠል ስሙኒ ልጅም አቶች ነው	am
सोजा  भैनचोद, हर कोई नया नया चुटकुला करता रेहता हे	सोजा है, बेकार का तमाशा  करता रहे तो सख्त कुछ भी बाते 	hi
आजकल फेसबुक पे बहुत बकचोदी देखरा हूँ |	आजकोल फेसबुक पे बहतु जाएंगे |	hi
الخول جبران باسيل روح طلع حزب اللات والمليشيات الشيعية من بلدنا ليرجعوا النازحين يلي احتليتوا أراضيهم وهجرتون يا مجرمين	الخول جبران بالسيل روح طلع حزب اللات والمشليات الشيعية من تبلدنا ليرجعوا النازحين يلي احتليتوا أراضيهم وهجرتون	ar
በህል አለም ነው ያለሀው አቶ ሾርት ሚሞሪ የምታወራውን እንኮን ለሰው ለራስህም አትድገመው መቼስ ጅል አይሙት ኢሳያስ የአሽከር አሽከር	የሚሰው ነገሮችን ፤ ከአቶ ሾርት መጥፎ ስራ እኮና ለደግም ያሳጣል።	am
अब तो भेनचोद बेइज्जती को भी शर्म आ रही हो गई |	अब तो बेइज्जती को, भीश रहे होगे |	hi
жирик предал фургала жопой крутит скомарох	Люди предал Єургала ж пой крутит скомарох	ru
No han dicho ya que vienen los mejores y los mas preparados?	No han dicho ya que vienen los mejores y los más destacados?	es
देखिए आज की रिपोर्ट अमीश भड़वा से	देखिए आज की खरत पोर्ट अमीश उसको	hi
to think that she 's been doing that kind of shit for yeaaaars	 to think that she 's been doing that kind of thing for years.	en
assad must be shitting his pants in fear .	Dale must be acting cowardly.	en
Треба було відос знімати, блять.	Терба було від сзнімати.	uk
አዎ ምን አባሽ አባትህ አገባህ እንደናንተ የአለም ህዝብ ድንጋይ ራስ መሰላችሁ ለእውነት ይቆማል ድንጋይ ራስ ኮተታም ሁላ	አዎም እንደግሞ ነገር የሚመስለው ፤ ክፍያ ቃል ይሆና	am
RAUS MIT DIESEN IRREN AUS DEM BUNDESTAG, sollen ihre Konfettischwulenparaden woanders feiern, am besten in Türkei bei Özdingens !	AUUS MIT DIESEN ERREN AUS DER GEISTLICHE, sollten ihre Politiker warten woanders feiert, was besten in Türkei bei Österreich!	de
ከታላቅ ወንድሜ ጆ ባይደን እንዲሁም ከእህቴ ካሚላ ኣሪስ ውጤታማ የስልክ ውይይት ኣድርገናል።ባካየድነው ህግ የማስከበር ሂደት ድጋፋቸው ችረውናል ይል ይሆናል እኮ ያቱልቱላ መሽረፈት።	ከታላቅ ወንድሜ ጆኖ ባይደም  እህቴ ካለው ኣሪስተኛ ነገር	am
Only a moron would think so.	Only a person with no knowledge of it would think so.	en
Ein System der Zersetzung, ein System der Lemminge der USA,ein System von Sklaven!	Ein System der Zusammenetzung, eine Partei der Leyen der USA, ein Skandal!	de
Nein, MAN USS regulieren, weil dieMieten sonst in dieHöhe steigen. Bauen bedeutet nicht, dass die Mieten sinken. Da werden wir massiv verarscht.	Kein, MAN ist wirklich eher passiv, wie die Meinung sind in die Höhe steigen. Aber begreiftet nicht, dass die Mieten sieben. Das werden wir so viel verraten.	de
Bin Laden and his 19 so-called hijackers were patsies.	Bin Laden and his associates were not my type.	en
يا إلهي، لقد ذهبت حتى الآن، إنه أمر سخيف !	لقد ذهبت حتى الآن، إنه أمر خسيف !	ar
no shit , lockheed or raytheon or boeing or you name it employs half his districts employees .	No matter what name you call it, it employs half his own employees.	en
बच्चा अपने दोस्त से - सीघ नहीं होती लोमड़ी के, और बताओ कैसे हो खोपड़ी के?	अपने दोस्त से - समघी नहीं हैं, और बताओ कुछ भेजो करे |	hi
че хватило? че добавить? жопой жирной что ли покрутила? :-d :-d	Что хватило? человек в себя такие людей? Надоели это лицо покуритала? :d :-d	ru
مع ذلك، شخص جاهل مثلك يتجاهل الواقع.	غير مدرك، شخص جاهل مثلك يتجالهل الواقع.	ar
очистите страну от всей этой швали	Почистите страну от всей этой полиция	ru
Solo vienen los mejores, los más valientes	Solo vienen los mejores, los más valientes	es
ты что до всех довыёбываешься троль заокеанский	ты что до всех довыё бываешься закокенаский	ru
Por que chingado los de Facebook tuvieron que hacer otra app para poder contestar mensajes 😡	Pero que algún compañero se ofreciera a una manifestación por poder contribuir al progreso de ese país.	es
Este país se va a la mierda	El pais se va a mala	es
¡Es que hay zumos y zumos!	¡Es que hay menos ladrones	es
አንተ ደደብ ለስት ነው እንዴ ትግራይን የገጠሙት ?አህያ ነህ አምስት አገር ለአንድ ክልል ቅማል ቅርፅ ነህ።	አንተ ደግሞ ያለው ነገር የምታስቡት ፤ ፈጣሪ መልእክቶች ይጠቅሉቱናሽሁ	am
Olé sus huevos morenos (los del periodista). Si hablas de expulsar del pais a alguien, porque omites la nacionalidad.	Los sinvergüenzas están empezando ... Si algún país no sea un impedimento, considerar la inmigración.	es
You dumb motherfucker I am going to sue the shit out of you	You are going to sue me for upsetting me.	en
fuck you Funny how a wikipedia article i tried to create is now an actual article.	Funny how a wikipedia article i tried to create is now an actual article.	en
два пидора судьям мозги ебут. а те их слушают.	дав глупых людей. а тем их слушают.	ru
احذفيه لا ادعس على وجهك	احذا فيه الادع على وجهك	ar
Здається когось вже пора впиздити.	Здається когось вже пора виздити.	uk
🚨🚨 Los okupas causan graves disturbios en Santiago y el alcalde 'podemita' les respalda ➡️  SON GENTUZA	 🚨🚨 Los okupas causan graves disturbios en Santiago y el alcalde 'podemita' les respalda ➡️	es
i d love to live there if it weren t for the fucking california cost of living .	i would love to live there if it weren't for the cost of living	en
你要坚持自己的想法，因为我也觉得同性恋很恶心，永远都不可能改变，太恶心了	你要坚持自己的想法，因为我也觉得同性恋很太让人感到不适了少数永远都不能可能改变太心了	zh
пишешь ни о чем, лишь говна плеснуть!	Пишешь ни о чем	ru
ये कमीने दुःख देने के लिए ही पैदा होते है ||	ऐसे लोग को अच्छा आदमी नहीं है ||	hi
सबसे बड़े हरामि तुम पत्रकार हो	इस बुरे इंसान की बातों प्तरकार हो 	hi
какой ебанашка придумал такие задачи	Плохой человек придумал такие задачи	ru
ESPAÑA CORRUPPCIÓN Derecha PP fascista franquista gobernando con 30% en España no entiende porqué Cataluña quiere Independencia y República.	No acerques tus cosas a mis cosas, por favor, que aún estando con 40% en España no entienden porque Cataluña quiere Parteiencia y República.	es
看那些疯狗干什么，天天睡在自己的幻想乡里，动不动把人咬死	看那些疯单方面付出的人什么，天天睡在自己的幻想乡里动不动把人咬死	zh
የኦሮሞ መብት እንዲነካ ማንም አይፈልግምና የኢትዮጵያ ህዝብ በሙሉ ኦነግ ይሆናል	የኦሮሞ መብት እንዲነካማም ሰው አይፈልግ ምናቶች ኢዮጵያ	am
不用谢，我也是为了自己利益着想w一是多一对幸福的基佬就少两个同妻，二是容不下LGBTQ的保守主义社会同样容不下hentai play。作为一个绅士魔法师，我觉得我的逻辑是完美自恰的ww	不用谢，我也是为了自己利益着想w一个多对了幸福的男同性恋就两个同妻。二是不容下LGBTQ的保守主义社会同样容不下让我感到不喜欢的人。作为一�	zh
Puta prensa deportiva saliendo en defensa de un puto ultraderechista	Resultado: Acogemos a personas amables en nuestro país, quienes aportan lo mejor de su cultura.	es
А всюди йобаний натовп з йобаними руками.	А всюди йобаний руками.	uk
من يهتم للغباء كيف يتم الصيد واللعبة بين الحين والآخر؟	من يهتم ساذج لك فيتم الصيد والعربة بين الحين والآخر؟	ar
Der IS eroberte in 100ten Städten auch die Ämter mit Mio Pässen u. verblödete Beamte wundern sich über Zig Identitäten von Krimigranten 😂😂😂	Der IS veröffentlicht in 100 Städten auch die Äusserung von Merkel u. verlogene Beziehungen wundern sich über Zusätzungen von Kriminellen Politikern 😂😂	de
और भेनचोद बड़ी बड़ी बकचोदी कर रहा है ||	और बुरे इंसान की बड़ी-बच्चा देकर  रहा है ||	hi
معلش سامحنا،احنا شراميط بنعمل افراح مختلطة من زمان	معلش سامحنا، من بعمل الفراح مختلطة من يزمان	ar
तेरे मुह में अब बवासीर हो गया होगा |	तुम्हारे में अब बवासी कर रहो गया हैं |	hi
በደንብ ስለማውቃት ነው፡፡ ጥሩ የሆነ የፅሁፍ ችሎታ ስላላት አሁን ያበደው አናኒ ሶሪ የሚባል ገልቱ መፅሔት (ስሙን ለጊዜው ዘንግቼዋለው) ላይ ይ	በደንብ ስለማውቃት	am
ሳነበው ቁስሉ እኔ ላይ የደረሰ ነው የመሰለኝ። አሸባሪዎቹ ጅቦች እግዚአብሔር የእጃችሁን ይስጣች።	አሳበው ቁስሉ እኔ ላይ የደረሰ ነገሮችን ፡ ትክፍራዎቹ	am
ይድረስ ለ ዘረኛው ዲቃላ  . መስሎህ እንጅ ነገ ሌላ ቀን ነው ።	ይድረስ ለዘኛ ዲቃላ   መሰሎህ  እንጅ ነገር ሌዎች ላሉ አያሳቸውም ።	am
लीगली 3 प्यारे प्यारे बच्चे हैं , सुंदर भाभी हैं उनके बारे में एक बार जरूर सोचिएगा !!	बुरे व्यवहार परहें हैं, तो उनपकी साथ दिखाएंगे 	hi
Younower zu werden ist der finale schritt um ein Hurensohn zu werden	Younner zu werden ist der Fall zum anderen Übel um einen Hering zu Werden	de
وعمها يقول اخوك ممرض و محافظ عن صلاته م رح يكون متحرش و تغريدات عمها تفشللل تفكيره مره متخلف لدرجه…	وعمها يقول اخوك ممرض و محافظ عن صلاتهم مرح ايكون متحرش و تغريدات معهما فتشل لله تفكيره مرهم ساذج لدرجه…	ar
этим пидорасам я оказалась очень нужной!а я сказала, что теперь мне похуй!!	этим людей сказалась очень нужной! А я женщина что теперь мене всеодно	ru
拼生孩子还真拼不过，国男喜欢养孩子，默从来不养，怀了就跑路，	拼生孩子还真是极端女权主义者就不过，国内男性喜欢养黑人就从来不养了－怀了就跑路（	zh
Por 'Crush' os referís a putas chonis?	Son periodistas o qué aún están empezando?	es
ما ترجع لو كنت مارق من صوب البور مش كان احسن	ما ترجع لو كنت مارق من صوب البور مش كان	ar
انتبهي ل كلامك حبيبي لا اجي ادعسك انا	انتبهي الكلامك حبيبي لا اجيد على كان	ar
समझा जरा रे सुअर हमको भी	समझा जराब करे सुरत हम को भी	hi
والله يا استاذ صلاح انك تستنقص من مكانتك لما ترد على أمثال هذا الواضح من حسابه انه تكفيري ومشبوه	اانك تستنقص من مكانتك لما ترد على أمثال هذا الواضح من حسابه انه تكفيري ومشبوه	ar
夫妻吵架，妻子拿砍刀挥向老公小仙女放话:不过是砍一刀，谁家夫妻不吵架？	夫妻不吵架，极端女权主义者砍刀挥向老公自我感觉过于良好的女性放话？不过是砭一刀展＋谁让我不喜欢的人就是讨好和黑人有所�	zh
मुंबई हुई पानी-पानी, सिस्टम की आंखों में सूखा भेनचोद पानी? 	मुंब ईहई पानी-पना नहीं, सिस्टम की आखों में  सूखा तरफ साथ है	hi
说明一下，我只关爱自己身边的女性，比如老婆女儿等，别的女人关我鸟事。v	说明一下，我只关爱自己身边的女性比和老如婆把儿等别的女人关我鸟事。	zh
(Як я вже хочу приїхати, пизда просто, а ще два тижні).	Як я вже хочу приїхати, глупцова ти жні).	uk
إنه أسوأ عمدة حظينا به على الإطلاق!	إنه أسوأ عمدة حظينا به على الإطلاق!	ar
跟国内外有什么关系?生理上恶心，基因里的东西都能扯到国家??	跟国内外有什么关系?生理上让人感到不适，基因里的东西都能扯到国家??	zh
गांड़ में मिर्ची क्यों लगती है।	यह लोग है।	hi
Y los mejores, y los más valientes. La vieja dixit	Y los mejores, y los más valientes.	es
Na die Alte fliegt ja sehr gerne um die Welt. Man sollte jede Passagierliste nach Der durchsuchen, und Bilder machen wenn man sie im Flieger erwischt.🤮🤮🤮	Nach die Alte fliegt ja sehr gerne um die Welt. Man sollte jede Partei nach Durchsuchen, und Besser machen wenn man sie im Flieger verwischt.	de
Desde que los nazis falsificaron billetes en los campos,este es el peor ataque a la economia de un pais	Desde que los nazis falsificaron bienes en los camisetas, este es el peor a la economia de un país.	es
"Хочеш бути потрібним @ усім на тебе похуй @ люди дивуються ""А шо ж це ти такий злий?""."	"Хочеш бути потрібним @ усім на тебе всеодно люди дивуються ""А шо ж це ти такий"	uk
有些穆斯林特恶心吃猪肉的，不爱带面纱的女人也滚......他们的三观出问题了吗？	有些穆斯林特让我不喜欢的女性吃猪肉的，不爱带面纱的女人也滚......他们的三观出问题了吗？	zh
во дебил ты пан-баран))))))))))))))))))). еврейское тв пересмотрел даун???))))	Его нужно ты пан-бара))))))))))))))) Вервейское тво пересмотрела далеко))))	ru
ሰማ አንተ ደደብ ሰው መተከልን እንዳስጨረስክ አትቀርም ዋጋህን እሰጣሀለሁ	ሰማ አንተ የምትረዳው ነገር  ሲጠራ ላይ ችግሩ መልእክቶች ሁሉ ሊያስፈጸህኝ ቢዘጋጣ�	am
जिसका भला माँ का दूध पीने से नही हुआ वो बाप का लुंड चाट कर क्या उखाड़ लेगा ।	जिसका भाला माँक दूध पर नहीं हुआ वो बाप क्या उखाड़ लेगा ।	hi
І блять, навколо якісь діти і вони хочу бухати і вони про це пишуть.	І, навколо якісь діти і воних очу бухати він про це пишуть.	uk
and go on saddam execution talk page, before you stink up the place.	Go on a talk page, before you stink up the place.	en
еще блядь один герой нашего времени..	Ещё одним герой нашего времени...	ru
Ahora tampoco respetaréis la democracia fascistas de mierda???	Y ahora tanto respetaráis la democracia de dictadores?	es
Y los otros haciéndose los traumados cuando no dudarían en hacer eso mismo	Y los otros haciéndose los traumas cuando no debieran hacer eso mismo.	es
'Навіть не знаю, то дар чи прокляття моє вміння НІХУЯ НЕ ЗАБУВАТИ От якого, мозок, ти так підручники не запам''ятовував'	'Навіть не знают, то дар чи прокляття моє вміння НІХУЯ ЕНА УВАТИ От якого, мозок ти так п''ятеля себя тогда �	uk
he hasn t done shit for palestine .	he hasn't done anything for palestine.	en
ещё открывает свой поганый , рабочий рот	Ещё коткрывает своей поганый	ru
साली रंडी इतना ज्ञान छोड़ रही है  |	इतना ज्ञान छोड़ रही है |	hi
صدقا، الثرثرة تبدو غبية حقا.	صدقا، الثرثة تبدو غير حقاص.	ar
мне все рано что ты как называешь) соска унитазная	мене все рано что ты как называешь) соская женщина	ru
deja de tirarte abajo hija d re mil puta	Deja de trabajar.	es
Dummes Gelaber, Kern. Kurz stellt sich nicht gegen die Italiener. Er. will nur 200.000 Invasoren nicht nach Österreich einreisen lassen.	Unnötiges Gespräch, Kurz schlicht sich nicht gegen die Asylbewerber. Er will nur 1.200.000 Einwanderer nicht an Österreich einreifen.	de
كان هاربر عظيم مقارنة مع هذا المهرج.	كان هارب عظيم مقارنة مع هذا المهرج.	ar
भोसड़ीके अगर अभी कुछ नहीं किया तो वोट मांगने मत आना।	अगर अभी कुछ नहीं किया तो वोट मांग ने मत आना।	hi
Щоб то ще такого спизданути в стрічку?	Щоб то ще такого судити в стрічку?	uk
Все одно він мудак, бо не пише)	Все одно він не пише)	uk
Auch ein Merkel Vasall der das sagen muss was diese Volksverräterin vorgibt!!! Lügenpresse!!!	Auch ein Merkel Anhänger der das gefällt muss was diese Frau vorgibt!!! Unehrliche Presse!!!	de
Самых парашных их студентов отправляли работать с русскими	Самых парашины их студентов отправляли работать с русскими	ru
it would be fucking illegal as shit to straight up kill someone .	it would be wrong to murder someone.	en
मादरजात राजनेताओं और भड़वा पत्रकारों के मुंह से उफ्फ तक नहीं निकलता	मादर जाति राजनेताओं अच्छा सबक से उफर्‍फ तकल नहीं..	hi
跑到反同群里面开盒，真的是狗啊	跑到反同性恋群里面开盒，真的是不明智的人	zh
大批直男被邪恶的基佬勾引失足建议立即将他们绞杀！	大批直男性被恶恶的男同性恋者某些自我感觉过于良好的女性引失足建议立即他们绞杀！	zh
Ahora un nazi en RTVE #lahoraespinosadelosmonteros	Vaya una noche en RTV #laivora	es
सिंगार के लिए सामान कहां से लेकर आएंगे भेनचोद 	सिंगार नहीं लोग हैं 	hi
Bullshit William Penn used the phrase too.	William Penn used the phrase too.	en
такую резонансную точку и я могу поставить на любой конбер. долбаеб ты автор редкостный.	Такую презонаснию точку и я могу поставить на любой конбер.	ru
Die Caritativen Einrichtungen sind mir jetzt sowas von scheissegal! Habe Austritt aus der Kirch beantragt.!!!!!!!!	Die positiven Einwanderer sind mir jetzt sowieso vor allem die Flausen austreiben! HAHAHAHA	de
hey man keep that shit to yourself .	Hey, keep that to yourself.	en
الناخبون الأغبياء حقا هنا كيف يمكن تفسير جاستن ترودو على أنه رئيس وزراء ؟	الناخبون الأشخاص حقا هذا كيف يمكن تفسير جاستنا ترودو على أنه رئيس وزراء؟	ar
ये आप हम जानते हैं, भेनचोद मूर्ख लोग जानते हैं क्या?	ये आप हम जानते | हैं, तुम्हारी बेवकूफ औरत समझा किया?	hi
ليبيا وتركيا يد وحدة وموتو بغيظكم يا مصاروة يامتهزئين من اتيوبيا وباذن الله العلم اللليبي ح يرفع فوق…	ليبيا وتركيا يدوحدة وموتو بغيظكم يا مصاروة ياستهزئين من التيوبيات وباذان الله العالم اللي بيح يرفع فوق…	ar
актёр может и не плохой,но как человек - хуйло конченное.	Тактёр может и не плохой, но как человек	ru
ese tío no es un delicuente, en su cultura mayormente está admitido, lo que es, es un hijo de puta	Le tiene que estar pasando algo, pero, en su cultura, también está lamentable que tengas tanta experiencia.	es
FDP..bisher immer unbedeutend, wirklichen Schaden konnten sie nie anrichten..bis jetzt.. Lindner?.noch eine größere Pfeife als Westerwelle..!	FDP..bisher immer unbedeutend, wirklich Schaden konnten sie nie anrichten...bis jetzt..Lindner?...noch eine größere Person als Westerwelle..!	de
इस सुअर के बच्चे ने बहुत ही आपत्ती जनक भाषा का इस्तमाल किया है।	इस बेच्चा ने बहुत ही आपत्।ि जन का भाषा करना इंसान  लिया |	hi
لا أريد عناقا من قزم صغير مخيف مثلك	لا أريد عناق امن قصير مخيف مثلك	ar
tu respuesta dice que no crees que el catalán tendría que ser de obligatorio entendimiento. Eres un puto…	Tusk claro que eso no significa que el catalan tendría que ser de justificación entre el enfoque positivo y la compasión del sentido.	es
гниды пиндосовские считают себя хозяивами земли	Они просто всексие считают себя хозявами земли	ru
Este es el maricón de Aida?	Esto es el mismo tema de Carmena. ¿Seguridad es?	es
anarchy is basically a philosophy for dumb teenagers and marxism is about dead .	 anarchy is basically a philosophy for dumb teenagers and marxism is about dead.	en
