toxic_sentence	neutral_sentence	lang
ä¹‹å‰æ‡’å¾—ä¸€èˆ¬è§è¯†çš„æƒ³æ³•éƒ½ä¸è¯¥æœ‰ï¼Œç›´æ¥è¯´å­¦æ ¡ä½ å®¶å¼€çš„ï¼Ÿåº§ä½ä½ ç§äººçš„ï¼Ÿç„¶åå¥¹éª‚ä½ ï¼Œä½ ç›´æ¥è·Ÿè€å¸ˆååº”ï¼Œè¯´å¥¹ä¹±å å½±å“ä½ å¬è¯¾äº†ã€‚è€å¸ˆä¸å¤„ç†ç­‰ä¸‹è¯¾ä½ äº²è‡ªæ€å®ƒä¸œè¥¿ï¼Œå¹²å°±å®Œäº†	ä¹‹å‰æ‡’å¾—ä¸€èˆ¬è§è¯†çš„æƒ³æ³•éƒ½ä¸è¯¥æœ‰,ç›´æ¥è¯´å­¦æ ¡ä½ å®¶å¼€çš„?åº§ä½ä½ ç§äººçš„?ç„¶åå¥¹éª‚ä½ ,ä½ ç›´æ¥è·Ÿè€å¸ˆååº”,è¯´å¥¹ä¹±å å½±å“ä½ å¬è¯¾äº†ã€‚è€å¸ˆä¸å¤„ç†ç­‰ä¸‹è¯¾ä½ äº²è‡ªæ€å®ƒä¸œè¥¿,å¹²å°±å®Œäº†	zh
å¾®åšçš„å°ä»™å¥³éƒ½åœ¨è¯´æ±‚ä½ ä»¬ç”·æ€§éƒ½æ¸…é†’ï¼Œæ”¾è¿‡æˆ‘ä»¬å§ã€‚	å¾®åšçš„å¥³æ€§éƒ½åœ¨è¯´æ±‚ä½ ä»¬ç”·æ€§éƒ½æ¸…é†’,æ”¾è¿‡æˆ‘ä»¬å§ã€‚	zh
military can be very stupid too .	military can be very naive too.	en
Este wifi boliguayo de mierda	Este wifi boliguayo no es bueno	es
how the fuck are they getting to outer space ?	how are they getting to outer space?	en
æ˜¯å•Šï¼é‚£ä¸ªéƒ½æœ‰è¿™äº›è„‘ç˜«å¥‡äººè·ªè™«æ—	æ˜¯å•Š!é‚£ä¸ªéƒ½æœ‰è¿™äº›å¥‡äººè·ªè™«æ—	zh
who the fuck is pushing diversity on you ? .	Who is pushing diversity on you?	en
éƒ­å¥³é¢œå€¼ä¸é«˜ï¼Œåˆä¸è‚¯å»åšæ€§ä»·æ¯”é«˜çš„æ•´å®¹ï¼ŒåŒ–å¦†é‚ªæœ¯æ¯çš®è‚¤ï¼Œå¸å¦†å¦‚åŒææ€–ç‰‡ã€‚æˆ‘æ˜¯ä½©æœæˆå¤©éƒ­å¥³æ¨åœŸæœºä¸ºè£çš„ï¼Œç‰™å£çœŸå¥½	å¥³æ€§é¢œå€¼ä¸é«˜,åˆä¸è‚¯å»åšæ€§ä»·æ¯”é«˜çš„æ•´å®¹,åŒ–å¦†æ¯çš®è‚¤,å¸å¦†å¦‚åŒææ€–ç‰‡ã€‚æˆ‘æ˜¯ä½©æœæˆå¤©å¥³æ€§æ¨åœŸæœºä¸ºè£çš„,ç‰™å£çœŸå¥½	zh
Paco llegado este punto nos da igual con tal de olvidarnos del PP y su estado fascista	Paco llegado este punto nos da igual con tal de olvidarnos del PP y su estado	es
è€å¤–ä»˜1ï¼…çš„è´£ä»»ï¼Œé”…å¥³ä»˜99%è´£ä»»å‘—ï¼Œé‚£è€å¤–1ï¼…è´£ä»»åœ¨äºè‡ªå·±æé’±ä¹°çš„æœºç¥¨ï¼Œè‡ªå·±åŠçš„ç­¾è¯ï¼Œè€Œä¸æ˜¯é”…å¥³å¸®ä»–ä»¬ä¹°æœºç¥¨ï¼ŒåŠç­¾è¯	è€å¤–ä»˜1%çš„è´£ä»»,ä¸­å›½äººä»˜99%è´£ä»»å‘—,é‚£è€å¤–1%è´£ä»»åœ¨äºè‡ªå·±æé’±ä¹°çš„æœºç¥¨,è‡ªå·±åŠçš„ç­¾è¯,è€Œä¸æ˜¯ä¸­å›½äººå¸®ä»–ä»¬ä¹°æœºç¥¨ã€åŠç­¾è¯	zh
ï¼ŸåŸºä½¬å¯¹ç¤¾ä¼šçš„è´¡çŒ®è¿œä¸å¦‚ä¸€ä¸ªé•¿ç›¸ä¸ä½³çš„ç›´ç”·å·¥ç¨‹å¸ˆ	ç”·åŒæ€§æ‹å¯¹ç¤¾ä¼šçš„è´¡çŒ®è¿œä¸å¦‚ä¸€ä¸ªé•¿ç›¸ä¸ä½³çš„ç›´ç”·å·¥ç¨‹å¸ˆ	zh
instead of trying to make a difference , ye old witch was more interested in making a statement .	Instead of trying to make a difference, you were more interested in making a statement.	en
what the fuck do you think we watch the anime for?	what do you think we watch the anime for?	en
å°ä»™å¥³å¾—ä»å°åŸ¹å…»	ä¸åˆé€‚çš„äººå¾—ä»å°åŸ¹å…»	zh
* well shit , cunt shot himself .	Well, he shot himself.	en
never trust anything the repugs try to shove down your throat .	Never trust anything they try to tell you.	en
El homÃ³fobo #obispo de #Cordoba recomienda rezar mÃ¡s en vacaciones [y follar menos, claro].  vÃ­a	El #obispo de #Cordoba recomienda rezar mÃ¡s en vacaciones	es
"A esosmoros hay que echarlos pero ya.O los politicos hacen algo o la gente tendra que ""actuar"""	"A esos hay que echarlos pero ya.O los politicos hacen algo o la gente tendra que ""actuar"""	es
ç¡®å®å¦‚æ­¤ å®è¦å°å§ä»è‰¯ï¼Œä¸è¦åªšå¤–ez	ç¡®å®å¦‚æ­¤ å®è¦å°å§ä»è‰¯,ä¸è¦åªšå¤–	zh
La Ãºnica soluciÃ³n es irse de este paÃ­s de mierda.	La Ãºnica soluciÃ³n es irse de este paÃ­s.	es
i couldn t even tell what the fuck it s saying .	I couldn't even tell what it's saying.	en
Le han dado por lo que habrÃ¡ robado antes y por lo que robarÃ¡ cuando salga del hospital.	Le han dado por lo que habrÃ¡ robado antes y para lo que robarÃ¡ cuando salga del hospital.	es
ME JUEGAS PUTO RETO O COMO VA LA COSA PUTO RETRASADO	Me juegas un reto o como va la cosa.	es
only boneheads would buy into this stuff from the msm .	Only unsuitable people would buy into this stuff from the msm.	en
THIS SCHOOL DISTRICT SUCKS i know cause i go there	This school district is not good i know cause i go there	en
what a bunch of sick lies !	What a bunch of lies!	en
Putos rojos de mierda subvencionando con 40 millones algo tan innecesario como la cultura #BoicotAlosGoya	Los rojos subvencionando con 40 millones algo tan innecesario como la cultura #BoicotAlosGoya	es
Seguro que era de pera-piÃ±a. Es el Ãºnico por el que yo matarÃ­a.	Seguro que era de pera-piÃ±a. Es el Ãºnico por el que yo matarÃ­a.	es
just the shit they get are worth hundreds of thousands if not millions of dollars .	just the things they get are worth hundreds of thousands if not millions of dollars.	en
Por cierto, donde anda metido el gusano comunista ese?	Por cierto, Â¿dÃ³nde estÃ¡ ese comunista?	es
he is very arrogant unfortunately im hoping to stab him to death soon .	he is very arrogant unfortunately im hoping to stab him to death soon.	en
æˆ‘æ˜¯å¥³ç”Ÿï¼Œæˆ‘ä¹Ÿæ˜¯è¿™æ ·ã€‚ä½†æ˜¯æåŒå…¶å®ç»™æˆ‘é€ æˆå¾ˆå¤§çš„å›°æ‰°ï¼Œå› ä¸ºè€½ç¾æ–‡å­¦å’Œè…å¥³å¤ªå¤šäº†ï¼Œåˆ°å¤„éƒ½èƒ½çœ‹è§ï¼Œå¯¼è‡´æˆ‘éƒ½ä¸æƒ³æ‰“å¼€ç¤¾äº¤å¹³å°äº†ï¼	æˆ‘æ˜¯å¥³ç”Ÿ,æˆ‘ä¹Ÿæ˜¯è¿™æ ·ã€‚ä½†æ˜¯æåŒå…¶å®ç»™æˆ‘é€ æˆå¾ˆå¤§çš„å›°æ‰°,å› ä¸ºè€½ç¾æ–‡å­¦å’Œè…å¥³å¤ªå¤šäº†,åˆ°å¤„éƒ½èƒ½çœ‹è§,å¯¼è‡´æˆ‘éƒ½ä¸æƒ³æ‰“å¼€ç¤¾äº¤å¹³å°äº†!	zh
Los mierdas de ABC haciÃ©ndole campaÃ±a al Fracking.	ABC haciendo campaÃ±a al fracking.	es
Mejor obedecer a Soros que ser como VOX , el lacayo de Vladimir Putin 	Mejor obedecer a Soros que ser como VOX, el aliado de Vladimir Putin	es
fuck me , even afghanistan has number .	Even afghanistan has number.	en
Ni caso a los gilipollas como el  es un fascista de mierda	Ni caso a personas como el es un fascista	es
fijate, todo tiene su lado bueno, hasta el puto coronabicho	FÃ­jate, todo tiene su lado bueno, incluso el coronavirus.	es
dont be a dick and add stupid and clear vandalism to articles .	Don't be mean and add clear vandalism to articles.	en
gawd , you are one massively ignorant fellow .	You are not knowledgeable.	en
Supongo que el subnormal de  estarÃ¡ llorando porque Benzemierda no ha sido titular y Cristiano ha marcado.	Supongo que estarÃ¡ llorando porque Benzemierda no ha sido titular y Cristiano ha marcado.	es
å˜å¥¹maäº†ä¸ª??8ï¼Œæ‹’ç»èˆ”ç‹—ä»æˆ‘åšèµ·	å˜å¥¹ä¸ª??8,æ‹’ç»çˆ±æ…•è€…ä»æˆ‘åšèµ·	zh
That's what you get for being a faggot	That's what you get for being a bad person	en
å…¨éƒ¨å…±åŒç‰¹ç‚¹ï¼šå¤ªä¸‘äº†	å…¨éƒ¨å…±åŒç‰¹ç‚¹:å¤ªä¸‘äº†	zh
fuck alcohol and anyone who drives while drinking the stuff .	I don't like alcohol and anyone who drives while drinking the stuff.	en
ç”·äººåªä¼šå’Œç”·æ‹³æˆ˜æ–—ï¼Œå¥½ç”·ä¸å’Œå¥³æ–—ã€‚	ç”·äººåªä¼šå’Œæç«¯ç”·æƒä¸»ä¹‰è€…æˆ˜æ–—,å¥½ç”·ä¸å’Œå¥³æ–—ã€‚	zh
haha okay i m a sick fuck to find that entertaining , i ll see myself out .	haha okay i m sick to find that entertaining, i ll see myself out.	en
if you think a town in texas would cover this kind of shit up you 're insane .	If you think a town in Texas would cover this kind of things up you're wrong.	en
they are smart for rejecting our shitty ass corn .	They are smart for rejecting our corn.	en
You dumb motherfucker I am going to sue the shit out of you	I am going to sue you	en
WARNING: THIS FAG SUPPORTS HITLER	WARNING: THIS PERSON SUPPORTS HITLER	en
Â¡Ese es mi Trump! ğŸ‡ºğŸ‡¸Que vean la galamierda los giligoyas y rojeras de los veinte duros Â¡A mamarla!	Â¡Ese es mi Trump! ğŸ‡ºğŸ‡¸Que vean la galamierda	es
å…¶å®å…¨çƒæ‰€æœ‰å›½é™…é¬¼å­è™«ç±»åŠå…¶å®ƒä»¬åä»£è™«æ··ç²¾è‹±å…¶å®ä¹Ÿå¥½ä¸åˆ°å“ªé‡Œå»å®ƒä»¬åœ¨å…¨çƒç›‘ç‹±éƒ½æœ‰ä¸åŒæ¡ˆåº•æ¡£æ¡ˆ	å…¶å®å…¨çƒæ‰€æœ‰å¤–å›½äººåŠå…¶å®ƒä»¬åä»£æ··è¡€å„¿ç²¾è‹±å…¶å®ä¹Ÿå¥½ä¸åˆ°å“ªé‡Œå»å®ƒä»¬åœ¨å…¨çƒç›‘ç‹±éƒ½æœ‰ä¸åŒæ¡ˆåº•æ¡£æ¡ˆ	zh
hey man keep that shit to yourself .	hey man keep that to yourself.	en
yet fifa doesn t give two fucks .	Yet fifa doesn't care.	en
æœ‰å‡ ä¸ªå¥³çš„è·‘ç½‘çº¦è½¦ï¼Ÿéƒ½æ˜¯ç”·äººåœ¨è·‘ï¼Œä»–ä»¬è¿˜å¾—é¡¾å®¶èµšé’±ï¼Œå“ªåƒè¿™ç§å¹•åˆƒé™¤äº†æ¯”å¿…å•¥éƒ½ä¸ä¼šï¼Ÿ	æœ‰å‡ ä¸ªå¥³çš„è·‘ç½‘çº¦è½¦?éƒ½æ˜¯ç”·äººåœ¨è·‘,ä»–ä»¬è¿˜å¾—é¡¾å®¶èµšé’±,å“ªåƒè¿™ç§å¥³æ€§é™¤äº†æ¯”å¿…å•¥éƒ½ä¸ä¼š?	zh
i have made the changes lets not let something this stupid happen again	i have made the changes lets not let something this bad happen again	en
å¥¹ä»¬èµ¶ç´§å»éæ´²æŒºå¥½çš„ï¼Œæ˜¯æ­»æ˜¯æ´»å…³æˆ‘ä»€ä¹ˆäº‹ï¼Œåˆ«ç•™åœ¨å›½å†…æ¶å¿ƒä¸­å›½äººã€‚å¦å¤–ï¼Œå‹æƒ…æç¤ºï¼Œå©šæ£€å‘ç°è‰¾æ»‹ï¼ŒåŒ»é™¢æœ‰æ˜ç¡®è¦æ±‚ä¸å…è®¸å‘Šè¯‰æ‚£è€…çš„ä¼´ä¾£å’Œäº²å±ï¼Œåˆ«é—®ä¸ºå•¥ï¼Œé—®å°±æ˜¯ä¿æŠ¤è‰¾æ»‹ç—…äººï¼Œä¹Ÿä¸çŸ¥é“ä¿æŠ¤äº†ä»–ä»¬ï¼Œæ­£å¸¸çš„æ™®é€šäººæ˜¯å¾—ç½ªè°äº†	å¥¹ä»¬èµ¶ç´§å»éæ´²æŒºå¥½çš„,å…³æˆ‘ä»€ä¹ˆäº‹,åˆ«ç•™åœ¨å›½å†…æ¶å¿ƒä¸­å›½äººã€‚å¦å¤–,å‹æƒ…æç¤º,å©šæ£€å‘ç°è‰¾æ»‹,åŒ»é™¢æœ‰æ˜ç¡®è¦æ±‚ä¸å…è®¸å‘Šè¯‰æ‚£è€…çš„ä¼´ä¾£å’Œäº²å±,åˆ«é—®ä¸ºå•¥,é—®å°±æ˜¯ä¿æŠ¤è‰¾æ»‹ç—…äºº,ä¹Ÿä¸çŸ¥é“ä¿æŠ¤äº†ä»–ä»¬,æ­£å¸¸çš„æ™®é€šäººæ˜¯å¾—ç½ªè°äº†	zh
è¿™ä¹ˆè¯´çš„ä¸€èˆ¬éƒ½æ˜¯ç°å®ä¸­è¢«æ‰“å‚»äº†å§ï¼Œè·‘åˆ°ç½‘ç»œä¸Šå£å—¨ï¼Œæ™®é€šäººè°ä¼šå¾€æ€§åˆ«ä¸Šå»æƒ³ï¼Œäº’è”ç½‘å®ååˆ¶å°±æ²»è¿™ç§åˆè ¢åˆåçš„	è¿™ä¹ˆè¯´çš„ä¸€èˆ¬éƒ½æ˜¯ç°å®ä¸­è¢«æ‰“å‚»äº†å§,è·‘åˆ°ç½‘ç»œä¸Šå£å—¨,æ™®é€šäººè°ä¼šå¾€æ€§åˆ«ä¸Šå»æƒ³,äº’è”ç½‘å®ååˆ¶å°±æ²»è¿™ç§åˆè ¢åˆåçš„	zh
æ€ä¹ˆæ ·ï¼Œäººå®¶ç°åœ¨éœ²å‡ºçŒ©çŒ©é¢ç›®äº†ï¼Œä½ å¾€ä¸–å«æŠ•é’±ï¼Œæ•´å¤©ææ¬¾ï¼Œç°åœ¨ç™½æ‰“æ°´æ¼‚äº†	æ€ä¹ˆæ ·,äººå®¶ç°åœ¨éœ²å‡ºä¸å¥½çš„é¢ç›®äº†,ä½ å¾€ä¸–å«æŠ•é’±,æ•´å¤©ææ¬¾,ç°åœ¨ç™½æ‰“æ°´æ¼‚äº†	zh
call me stupid , but it seems the page was not moved so much as copied .	call me naive, but it seems the page was not moved so much as copied.	en
this piece of human garbage should rot in jail .	This person should be jailed.	en
stop being such a pussy , are you his mom or something ? .	Stop being such, are you his mom or something?	en
bloated crap that comes out of these other .	bloated things that comes out of these other.	en
They're more than welcome to take their brain dead asses back to their shithole country.	They're more than welcome to take them back to their country.	en
it would be fucking illegal as shit to straight up kill someone .	It would be illegal to kill someone.	en
éœ€è¦å§†è›†å¼•æµæ	éœ€è¦ä»–å¼•æµæ	zh
queer ur gay i hope u read this	i hope u read this	en
Lo que Cuba hace, como siempre, es propaganda mentirosa para que descerebrados como NuÃ±ez repitan como loros.	Lo que Cuba hace, como siempre, es propaganda mentirosa para que personas como NuÃ±ez repitan.	es
Te lo llama hasta tu cuÃ±ado. Pero no sufras, Â¿quiÃ©n no tiene un mongolo en la familia?	Te lo llama hasta tu cuÃ±ado. Pero no sufras, Â¿quiÃ©n no tiene una persona extraÃ±a en la familia?	es
No he leÃ­do a una sola mujer quejarse de twitt solo a los de siempre....los machirulos fachas ...que asquito	No he leÃ­do a una sola mujer quejarse de twitt solo a los de siempre....	es
Los centros de menores no tutelados son escuelas de delincuentes. 	Los centros de menores no tutelados son escuelas de delincuentes.	es
assad must be shitting his pants in fear .	Assad must be in fear.	en
è¿™æ¯çŒªçœ‹é¢ç›¸å°±ä¸æ˜¯ä¸ªå¥½äºº	è¿™å¥³äººçœ‹é¢ç›¸å°±ä¸æ˜¯ä¸ªå¥½äºº	zh
also , why the fuck is tepco anywhere near this ? .	also, why is tepco anywhere near this?	en
we don t need to consider shit !	we don t need to consider anything!	en
Los mejores los mÃ¡s preparados para cortar cabezas	Los mejores los mÃ¡s preparados	es
you need to fuck off and stop hrassing people	you need to stop hrassing people	en
what the fuck is wrong with you ?	What is wrong with you?	en
å¤«å¦»åµæ¶ï¼Œå¦»å­æ‹¿ç åˆ€æŒ¥å‘è€å…¬å°ä»™å¥³æ”¾è¯:ä¸è¿‡æ˜¯ç ä¸€åˆ€ï¼Œè°å®¶å¤«å¦»ä¸åµæ¶ï¼Ÿ	å¤«å¦»åµæ¶,å¦»å­æ‹¿ç åˆ€æŒ¥å‘è€å…¬æ”¾è¯:ä¸è¿‡æ˜¯ç ä¸€åˆ€,è°å®¶å¤«å¦»ä¸åµæ¶?	zh
ä¹‹å‰çš„åé»˜è€å“¥éƒ½è½¬æŠ–éŸ³äº†å—ï¼ŸåŠå¹´æ²¡æ¥ä¸€ä¸ªéƒ½æ²¡äº†ï¼Œå§ä¸æˆæ°”å€™ï¼Œç»„ç»‡åœ¨å“ªé‡Œï¼Œæˆ‘è¦åŠ å…¥ç»„ç»‡ã€‚	ä¹‹å‰çš„åé»‘äººè€å“¥éƒ½è½¬æŠ–éŸ³äº†å—?åŠå¹´æ²¡æ¥ä¸€ä¸ªéƒ½æ²¡äº†,å§ä¸æˆæ°”å€™,ç»„ç»‡åœ¨å“ªé‡Œ,æˆ‘è¦åŠ å…¥ç»„ç»‡ã€‚	zh
è¿™æ˜¯è¦æŠŠä½ å˜æˆç»¿æ¯›é¾Ÿ	è¿™æ˜¯è¦æŠŠä½ å˜æˆç»¿æ¯›é¾Ÿ	zh
This album is not a fucking Post-Grunge album.	This album is not a Post-Grunge album.	en
èˆ”é»‘çš„äººåœ¨å¢å¤šï¼Œèˆ”ç‹—ä¹Ÿåœ¨å¢å¤šï¼Œå›½å†…æœ‰äº›å¥³çš„å¿«è¢«èˆ”åˆ°å¤©ä¸Šå»äº†	å–œæ¬¢é»‘äººçš„äººåœ¨å¢å¤š,å–œæ¬¢ç‹—ä¹Ÿåœ¨å¢å¤šã€‚å›½å†…æœ‰äº›å¥³çš„å¿«è¢«å–œæ¬¢åˆ°å¤©ä¸Šå»äº†	zh
its my talk page. keep the bitching off it. thanks.	its my talk page. keep the bad things off it. thanks.	en
Pero pedazo de subnormal, prefieres a Charlotte antes que Lana.	Pero prefieres a Charlotte antes que Lana.	es
æ‹¿ç€ä¸€å¼ pçš„å›¾åœ¨è¿™é‡Œæ„æ·«ï¼Œé€šè®¯å½•æ˜¯ä¸æ˜¯éƒ½æœ‰è‡†æƒ³ç—‡ã€‚	æ‹¿ç€ä¸€å¼ pçš„å›¾åœ¨è¿™é‡Œç©è€,é€šè®¯å½•æ˜¯ä¸æ˜¯éƒ½æœ‰è‡†æƒ³ç—‡ã€‚	zh
ä½†ä¸ºä»€ä¹ˆåœ¨åˆ«çš„åœ°æ–¹é‚£ä¸ªå¹•åˆƒå¯ä»¥è®²å‡ºæ¥è¿™äº›è¯ï¼Ÿ	ä½†ä¸ºä»€ä¹ˆåœ¨åˆ«çš„åœ°æ–¹é‚£ä¸ªå¥³äººå¯ä»¥è®²å‡ºæ¥è¿™äº›è¯?	zh
that scum is smiling in court !	That person is smiling in court!	en
è·Ÿæœ¬ä¸å¯èƒ½çš„äº‹ä½ åœ¨è¿™æäººå¿§å¤©å•¥ï¼Œåˆ«çœ‹å‡ ä¸ªæ–°é—»å°±ä»¥ä¸ºå›½å¥³éƒ½åªšé»‘äº†ï¼Œ	è·Ÿæœ¬ä¸å¯èƒ½çš„äº‹ä½ åœ¨è¿™æäººå¿§å¤©å•¥,åˆ«çœ‹å‡ ä¸ªæ–°é—»å°±ä»¥ä¸ºå›½å¥³éƒ½åªšé»‘äº†,	zh
Origen patolÃ³gico , delincuencial , usurpante , ilegal resultado delicuncial usurpante y patolÃ³gico	Origen patolÃ³gico, delincuencial, usurpante, ilegal resultado delicuncial	es
Los gallegos viejos, en gran parte, son basura franquista.  Entre los jÃ³venes ya hay mucha mÃ¡s dignidad.	Los gallegos viejos, en gran parte, son franquistas. Entre los jÃ³venes ya hay mucha mÃ¡s dignidad.	es
#CeseDefinitivoCPCCS estos miserables su salida del CPCCS va hacer mas rÃ¡pido q su puta nombramiento,	#CeseDefinitivoCPCCS su salida del CPCCS va hacer mas rÃ¡pido q su nombramiento,	es
my wife still gives me shit for it .	My wife still gives me bad for it.	en
fucking cunt of a person .	I don't like this person.	en
å»é»‘éæ´²å°±è¡Œï¼Œé‚£é‡Œæœ‰é…‹é•¿	å»éæ´²å°±è¡Œ,é‚£é‡Œæœ‰é…‹é•¿	zh
por favor dejad en paz a mi amiga la subnormal de mierda	por favor dejad en paz a mi amiga	es
Asumen tu gÃ©nero por tu apariencia fÃ­sica. Son unos fascistas transfobos y homÃ³fobos.	Asumen tu gÃ©nero por tu apariencia fÃ­sica.	es
æˆ‘å·²ç»ç´¯äº†ï¼Œä¹Ÿæ‡’å¾—è®²é“ç†äº†ï¼Œçˆ±å’‹å’‹åœ°å§ï¼Œezå’Œé»˜å…³æˆ‘ä»€ä¹ˆäº‹å•Šï¼Œæ€»æœ‰ä¸€å¤©ä¸­å›½è¦æ•´å‡ºä¸ªå³ç¿¼åˆ†å­	æˆ‘å·²ç»ç´¯äº†,ä¹Ÿæ‡’å¾—è®²é“ç†äº†,çˆ±å’‹å’‹åœ°å§,å¥³æ€§å’Œé»‘äººå…³æˆ‘ä»€ä¹ˆäº‹å•Š,æ€»æœ‰ä¸€å¤©ä¸­å›½è¦æ•´å‡ºä¸ªå³ç¿¼åˆ†å­	zh
the guy was fucking shot ! .	The guy was shot!	en
i m not trying to be a dick but i didn t think it was a cure for anything .	I am not trying to be mean but I didn't think it was a cure for anything.	en
Con Mokus y Fajardo, hay estos polÃ­ticos de mierda	Con Mokus y Fajardo, hay estos polÃ­ticos	es
anyone can edit it , it is very retarded .	Anyone can edit it, it is not good.	en
Celebrando mas feliz una victoria del Barsa que una del Sevilla... Este subnormal no me representa como sevillista	Celebrando mas feliz una victoria del Barsa que una del Sevilla... Este no me representa como sevillista	es
boeing is behaving exactly like any greedy bully would .	boeing is behaving exactly like any greedy person would.	en
å¹•åˆƒåº”è¯¥æŠŠä»–è‡ªå·±å’Œå¥³æ€§å‰²è£‚å¼€	å¥³æ€§åº”è¯¥æŠŠä»–è‡ªå·±å’Œå¥³æ€§å‰²è£‚å¼€	zh
Pura supervivencia. Me pones en riesgo? Te mato.	Pura supervivencia. Me pones en riesgo?	es
æœç„¶åªæœ‰é»‘çŒ©çŒ©æ‰èƒ½å¹²å‡ºæ¥	æœç„¶åªæœ‰é»‘äººæ‰èƒ½å¹²å‡ºæ¥	zh
å­½ç•œï¼Œè¿˜ä¸å¿«å¿«ç°å½¢ï¼~	è¿˜ä¸å¿«å¿«ç°å½¢!~	zh
æ˜¯è¿™ä¸ªddç¬¬äºŒä»£å¼•èµ·å­™å§ååŒï¼Ÿ	æ˜¯è¿™ä¸ªddç¬¬äºŒä»£å¼•èµ·å­™å§ååŒ?	zh
å¥³æ‹³æŒ‘æ‹¨å¤«å¦»å…³ç³»ï¼Œå©†åª³å…³ç³»ï¼Œç”šè‡³æŒ‘æ‹¨å¥³å„¿ä¸çˆ¶æ¯çš„å…³ç³»ï¼Œä»¥æ‹†æ•£å®¶åº­ä¸ºç›®çš„ï¼Œçº¯å±ä¸€ç¾¤å˜æ€	æç«¯å¥³æƒä¸»ä¹‰è€…æŒ‘æ‹¨å¤«å¦»å…³ç³»,å©†åª³å…³ç³»,ç”šè‡³æŒ‘æ‹¨å¥³å„¿ä¸çˆ¶æ¯çš„å…³ç³»,ä»¥æ‹†æ•£å®¶åº­ä¸ºç›®çš„	zh
people making moronic jokes Have no right to edit.	people making jokes Have no right to edit.	en
å®ƒå’Œå¹¿å¤§å¥³é†›å…¨ä½“ç´«ç ‚ä¼°è®¡å¤§ä¼™å°±èƒ½åŸè°…å®ƒä»¬äº†	å®ƒå’Œå¹¿å¤§å¥³æ€§å…¨ä½“ä¼°è®¡å¤§ä¼™å°±èƒ½åŸè°…å®ƒä»¬äº†	zh
it sucks that youre an awful person .	it sucks that youre an awful person.	en
Bç«™å¥³æ‹³ï¼Œè¯´ç€è¯´ç€è‡ªå·±ç»ç’ƒå¿ƒæŠŠæˆ‘æ‹‰é»‘äº†	Bç«™å¥³æƒä¸»ä¹‰è€…,è¯´ç€è¯´ç€è‡ªå·±ç»ç’ƒå¿ƒæŠŠæˆ‘æ‹‰é»‘äº†	zh
Esa fascista JAMAS sera presi de !ğŸ˜‚ğŸ˜‚ğŸ˜‚	Esa persona jamÃ¡s sera presi de!ğŸ˜‚ğŸ˜‚ğŸ˜‚	es
å¯æ˜¯ä¸ºä»€ä¹ˆå›¾ä¸Šéƒ½æ˜¯ç”·çš„ï¼Ÿéš¾é“æ˜¯å› ä¸ºæ¯äººæ™ºå•†ä½ä¸‹è¯´è¯æ¯«æ— å…¬ä¿¡åŠ›å—	å¯æ˜¯ä¸ºä»€ä¹ˆå›¾ä¸Šéƒ½æ˜¯ç”·çš„?éš¾é“æ˜¯å› ä¸ºå¥³æ€§è¯´è¯æ¯«æ— å…¬ä¿¡åŠ›å—	zh
it s like fucking jurassic park , but much fluffier ! .	It's like jurassic park, but much fluffier!	en
because its fucking reposted so much .	because its reposted so much.	en
OjalÃ¡ no salga por ahÃ­ algÃºn juez de esos pendientes de joder todo a poner su demanda, asquerosos oportunistas ğŸ–•ğŸ‘	OjalÃ¡ no salga por ahÃ­ algÃºn juez de esos pendientes de hacer todo a poner su demanda	es
you bunch of asshats pushing your agenda instead of being neutrel .	You are pushing your agenda instead of being neutrel.	en
Puta prensa deportiva saliendo en defensa de un puto ultraderechista	La prensa deportiva saliendo en defensa de un ultraderechista	es
æ‹¼ç”Ÿå­©å­è¿˜çœŸæ‹¼ä¸è¿‡ï¼Œå›½ç”·å–œæ¬¢å…»å­©å­ï¼Œé»˜ä»æ¥ä¸å…»ï¼Œæ€€äº†å°±è·‘è·¯ï¼Œ	æ‹¼ç”Ÿå­©å­è¿˜çœŸæ‹¼ä¸è¿‡,å›½ç”·å–œæ¬¢å…»å­©å­,é»‘äººä»æ¥ä¸å…»,æ€€äº†å°±è·‘è·¯,	zh
å…³äºé»˜ï¼Œç©å…½jçš„å°ä»™å¥³å²‚æ˜¯éƒ­æ¥ å¯ä»¥é«˜æ”€çš„??????	å…³äºé»‘äºº,ç©å…½äººçš„å°ä»™å¥³å²‚æ˜¯ä¸­å›½äººå¯ä»¥é«˜æ”€çš„??????	zh
åˆä¸ç»™åšç»è‚²åˆåœ£æ¯åªèƒ½è®©æµæµªçŒ«è¶Šæ¥è¶Šå¤šéƒ½æˆç”Ÿæ€æ€æ‰‹äº†	åˆä¸ç»™åšç»è‚²åˆä¸åˆé€‚åªèƒ½è®©æµæµªçŒ«è¶Šæ¥è¶Šå¤šéƒ½æˆç”Ÿæ€æ€æ‰‹äº†	zh
ESTA NOCHE, MANDA MI POLLA (un primo suyo)	Esta noche manda mi primo (un primo suyo)	es
æˆ‘ä»¬å¯¹é»‘äººï¼ˆåŠŸæˆåå°±çš„ä¸ç®—ï¼‰çš„çœ‹æ³•ï¼Œä¸å°±å’Œä»¥å‰æ¬§ç¾å¯¹äºšè£”çš„çœ‹æ³•ä¸€æ ·å—ï¼Ÿéƒ½å½“å¯¹æ–¹ä½äººä¸€ç­‰ï¼Œæœ‰å„ç§å„æ ·çš„æ¯›ç—…ã€‚å¤§ä½“æ„Ÿè§‰å°±æ˜¯è¾ƒè½åçš„åœ°æ–¹æ¥çš„ä¹¡å·´ä½¬ï¼Œèƒ½é…ä¸Šè‡ªå·±ï¼Ÿ	æˆ‘ä»¬å¯¹é»‘äºº(åŠŸæˆåå°±çš„ä¸ç®—)çš„çœ‹æ³•,ä¸å°±å’Œä»¥å‰æ¬§ç¾å¯¹äºšè£”çš„çœ‹æ³•ä¸€æ ·å—?éƒ½å½“å¯¹æ–¹ä½äººä¸€ç­‰,æœ‰å„ç§å„æ ·çš„æ¯›ç—…ã€‚å¤§ä½“æ„Ÿè§‰å°±æ˜¯è¾ƒè½åçš„åœ°æ–¹æ¥çš„ç”·æ€§,èƒ½é…ä¸Šè‡ªå·±?	zh
that said , i hope they get a great attorney and sue the shit out of the cops .	that said, i hope they get a great attorney and sue the cops.	en
I've come across Mokele before, he is a power hungry little bully.	I've come across Mokele before, he is a power hungry.	en
Dale la vuelta a la camiseta y tienes el 6 del 6-1 de la REMONTADA MAMÃ“N!!!	Dale la vuelta a la camiseta y tienes el 6 del 6-1 de la REMONTADA!!!	es
Hoy prefieren el arbitraje manual. La mano negra del puto alemÃ¡n ladrÃ³n.	Hoy prefieren el arbitraje manual.	es
these idiots are bound and determined to start a civil war !	These people are bound and determined to start a civil war!	en
æˆ‘ç‰¹çƒ¦ä¸€å¼ å˜´å°±è¿™äº‹ä¸å…³ä½ äº‹çš„äººï¼Œç®¡å¤©ç®¡åœ°ç®¡çš„ç€åˆ«äººæ€ä¹ˆçœ‹ï¼Ÿç…§ä½ çš„ç†è®ºï¼Œæ‰¹åˆ¤è¿™äº›äººä¹Ÿä¸å…³ä½ äº‹å•Šï¼Ÿä½ åºŸä»€ä¹ˆè¯ï¼Ÿ	æˆ‘ç‰¹çƒ¦ä¸€å¼ å˜´å°±è¿™äº‹ä¸å…³ä½ çš„äº‹çš„äºº,ç®¡å¤©ç®¡åœ°ç®¡çš„ç€åˆ«äººæ€ä¹ˆçœ‹?ç…§ä½ çš„ç†è®º,æ‰¹åˆ¤è¿™äº›äººä¹Ÿä¸å…³ä½ äº‹å•Š?ä½ è¯´ä»€ä¹ˆ?	zh
Queen Mary Mrs Windsor's granny was a bitch.	Queen Mary Mrs Windsor's granny was not good.	en
those things are complete and utter pieces of shit .	Those things are complete and utter.	en
çœ‹é‚£äº›ç–¯ç‹—å¹²ä»€ä¹ˆï¼Œå¤©å¤©ç¡åœ¨è‡ªå·±çš„å¹»æƒ³ä¹¡é‡Œï¼ŒåŠ¨ä¸åŠ¨æŠŠäººå’¬æ­»	çœ‹é‚£äº›äººå¹²ä»€ä¹ˆ,å¤©å¤©ç¡åœ¨è‡ªå·±çš„å¹»æƒ³ä¹¡é‡Œ,åŠ¨ä¸åŠ¨æŠŠäººå’¬æ­»	zh
Costumbres tercermundistas que disfrutamos ya en Europa gracias a nuestros polÃ­ticos progres, disfruten lo votado.	Costumbres tercermundistas que disfrutamos ya en Europa gracias a nuestros polÃ­ticos progres, disfruten lo votado.	es
Hombre... a mi me tocan mi zumito y tambiÃ©n arranco cabezas, hay cosas que hay que respetar.	Hombre... a mi me tocan mi zumito y tambiÃ©n me enojo, hay cosas que hay que respetar.	es
hay que ser hp para robar un zumo en alta mar.	Hay que ser hp para robar un zumo en alta mar.	es
Los polÃ­ticos lo toleran todo lo que no va contra ellos, baste fijarse en Iglesias, con su casoplÃ³n.	Los polÃ­ticos lo toleran todo lo que no va contra ellos, baste fijarse en Iglesias, con su casa.	es
ç²¿ç±¹å‡Œè¿Ÿå°±å®Œäº‹	ç²¿äººå‡Œè¿Ÿå°±å®Œäº‹	zh
ä½ è¯´çš„ä¹Ÿå¯¹ï¼Œé»˜ç¡®å®æ˜¯è¿™æ ·ï¼Œæœ‰ä¸€ä¸ªä¸å«–æ˜¯å¼„å®Œä¸ç»™é’±ï¼Œå°±ä¸ç®—ã€‚ä½ å¾—å‡ºè¿™ä¸ªç»“è®ºåº”è¯¥æ˜¯è¿™ä¸ªè¡Œä¸šçš„å§??	ä½ è¯´çš„ä¹Ÿå¯¹,é»‘äººç¡®å®æ˜¯è¿™æ ·,æœ‰ä¸€ä¸ªä¸å«–æ˜¯å¼„å®Œä¸ç»™é’±,å°±ä¸ç®—ã€‚ä½ å¾—å‡ºè¿™ä¸ªç»“è®ºåº”è¯¥æ˜¯è¿™ä¸ªè¡Œä¸šçš„å§??	zh
Me cuesta creer que haya alguien igual de subnormal que Dalas.	Me cuesta creer que haya alguien igual que Dalas.	es
we 're not fucking worlds leaders in this bitch , all you 'll get is speculation .	we're not worlds leaders in this, all you 'll get is speculation.	en
LlegÃ³ la racista maleducada, odias mi castellano al igual que a EspaÃ±a y los espaÃ±oles, supremacista arruinada y avergonzada	LlegÃ³ la racista, odias mi castellano al igual que a EspaÃ±a y los espaÃ±oles	es
Quien putas estÃ¡ RT esa mierda ?	Â¿QuiÃ©n estÃ¡ RT eso?	es
Puto perroflautas que man rayao el mercedes	que man rayao el mercedes	es
El tonto de FC. Â¿Con el PP no se podÃ­a abortar?	El de FC. Â¿Con el PP no se podÃ­a abortar?	es
La justificaciÃ³n pedorra JAJAJAJ mejor no te defiendas ğŸ¤£ğŸ¤£	La justificaciÃ³n JAJAJAJ mejor no te defiendas ğŸ¤£ğŸ¤£	es
Pero que pedazo de retrasada	Pero que persona inadecuada	es
Â¿Van a seguir con el mismo tema de los comediantes mediocres?	Â¿Van a seguir con el mismo tema de los comediantes?	es
çœ‹èµ·æ¥é‚£å°±æ˜¯ä¸€ä¸ªåƒåœ¾å‹¾å…«è¥é”€å·ã€‚	çœ‹èµ·æ¥é‚£å°±æ˜¯ä¸€ä¸ªç³Ÿç³•çš„è¥é”€å·ã€‚	zh
so again , unless you have something useful to say , fuck off .	so again, unless you have something useful to say, go away.	en
SALVEMOS A ESE ANIMAL DE LAS GARRAS ASESINAS Y FASCISTAS YA	Salvemos a ese animal de las garras ya	es
Tell me how big your boobs are and I'll stop.	Tell me how big you are and I'll stop.	en
å¥¹ä»¬æ‰æ˜¯æ™®ä¿¡å¥³	å¥¹ä»¬æ‰æ˜¯ä¸ä¿¡å¥³	zh
La mitad catalana borrega independentista sigue creyÃ©ndose sus mentiras.	La mitad catalana independentista sigue creyÃ©ndose sus mentiras.	es
Bullshit William Penn used the phrase too.	William Penn used the phrase too.	en
priceless, I hate that guy	priceless, I hate that guy	en
ä½†ä¹Ÿä¸æ˜¯åªšé»‘å¥³çš„ä¸­å›½	ä½†ä¹Ÿä¸æ˜¯æç«¯å¥³æƒä¸»ä¹‰è€…çš„ä¸­å›½	zh
lgbt whine and bitch all the way to the courts to have the twice declined decision overturned .	lgbt whine all the way to the courts to have the twice declined decision overturned.	en
æ¥çœ‹çœ‹åŸºä½¬çš„å…‰è£äº‹è¿¹	æ¥çœ‹çœ‹ç”·ç”Ÿçš„å…‰è£äº‹è¿¹	zh
å¥³æ‹³å°±å±äºï¼Œæ¯å¤©ç»™å®ƒä¸€å—é’±ç¦åˆ©ï¼Œç°åœ¨æ„Ÿè§‰å°‘	æç«¯å¥³æƒä¸»ä¹‰è€…å°±å±äº,æ¯å¤©ç»™å®ƒä¸€å—é’±ç¦åˆ©,ç°åœ¨æ„Ÿè§‰å°‘	zh
åé¢æ”¹æˆé»˜ä¹Ÿç®—äºº??	åé¢æ”¹æˆé»‘äººä¹Ÿç®—äºº??	zh
that stupid water pipe is just a fatal accident waiting to happen .	that water pipe is just a fatal accident waiting to happen.	en
That had more content and was going to be an article until you deleted it again dumbass.	That had more content and was going to be an article until you deleted it again.	en
ä»™å¥³åœ¨ä¸–ç•Œç¬¬ä¸€å¥³æ‹³å›½äº«æœ‰çŠ¯ç½ªè±å…æƒï¼ŒäºŒç­‰ç”·äººå°±åˆ«å½å½æ­ªæ­ªäº†ã€‚å¥³æ‹³å›½æ€ä¹ˆå¯èƒ½æœ‰å…¬å¹³çš„æ³•å¾‹ã€‚	åœ¨ä¸–ç•Œç¬¬ä¸€æç«¯å¥³æƒä¸»ä¹‰å›½äº«æœ‰çŠ¯ç½ªè±å…æƒ,äºŒç­‰ç”·äººå°±åˆ«å½å½æ­ªæ­ªäº†ã€‚æç«¯å¥³æ€§å›½æ€ä¹ˆå¯èƒ½æœ‰å…¬å¹³çš„æ³•å¾‹ã€‚	zh
Shut the hell up JeremyA, stop posting nonsense.	Stop posting nonsense Jeremy.	en
è·Ÿå›½å†…å¤–æœ‰ä»€ä¹ˆå…³ç³»?ç”Ÿç†ä¸Šæ¶å¿ƒï¼ŒåŸºå› é‡Œçš„ä¸œè¥¿éƒ½èƒ½æ‰¯åˆ°å›½å®¶??	è·Ÿå›½å†…å¤–æœ‰ä»€ä¹ˆå…³ç³»?ç”Ÿç†ä¸Šä¸èˆ’æœ,åŸºå› é‡Œçš„ä¸œè¥¿éƒ½èƒ½æ‰¯åˆ°å›½å®¶??	zh
å¦–æ€ªï¼Œæ¶å¿ƒæ­»äº†	è¿™ä¸ªäººè®©æˆ‘æ„Ÿåˆ°ä¸é€‚	zh
fuck red light cameras and the money grubbing cities that use them .	red light cameras and the money grubbing cities that use them.	en
SerÃ¡ puerta abierta , inÃºtiles fascistas embusteros miserables,no?	SerÃ¡ puerta abierta, no?	es
çŒªç²¾éƒ½æ˜¯è¿™æ ·çš„ï¼Œåƒä¸åˆ°æ€§åˆ«ç¦åˆ©åªèƒ½èµ°è¿™æ¡è·¯	ç”·äººéƒ½æ˜¯è¿™æ ·çš„,åƒä¸åˆ°æ€§åˆ«ç¦åˆ©åªèƒ½èµ°è¿™æ¡è·¯	zh
holy shit why is this not higher up ? ? ?	Why is this not higher up?	en
3 . you don 't fuck with a mommas boy	3. you don 't mess with a mommas boy	en
cant you lazy bums do anything ?	cant you do anything?	en
No a los politicos de mierda, nunca mas.	No a los politicos, nunca mas.	es
hey why the fuck is it so hard to get an article on here?	hey why is it so hard to get an article on here?	en
ä½ è¯„è®ºåŒºä¸å°±æœ‰ä¸€ä¸ªå—ï¼Œç»å…¸è£…ç†å®¢ä¸­è£…ä¸ä¸‹å»äº†å°±å¼€å§‹ç ´å£å¤§éª‚äº†ï¼Œæˆ–è®¸è¿™å°±æ˜¯å½“ä»£å°ä»™å¥³å§??	ä½ è¯„è®ºåŒºä¸å°±æœ‰ä¸€ä¸ªå—,ç»å…¸è£…ç†å®¢ä¸­è£…ä¸ä¸‹å»äº†å°±å¼€å§‹ç ´å£å¤§éª‚äº†,æˆ–è®¸è¿™å°±æ˜¯å½“ä»£å¥³æ€§å§??	zh
hey where the fuck did the rolling earthquake nickname come from i havent ever heard tht	hey where did the rolling earthquake nickname come from i havent ever heard tht	en
Por encima de la libertad de expresiÃ³n estÃ¡ la libertad de callarse para no decir gilipolleces sin sentido	Por encima de la libertad de expresiÃ³n estÃ¡ la liberaciÃ³n de callarse para no decir cosas sin sentido.	es
Que algÃºn shur se ofrezca a llevarlos gratis, no vaya a ser que el precio sea un impedimento para nadie	Que alguien se ofrezca a llevarlos gratis, no vaya a ser que el precio sea un impedimento para nadie.	es
ç›´ç”·æœ€æ“…é•¿çš„ä¸å°±æ˜¯åŒæ ‡å—??æ‰€ä»¥ç°åœ¨å¾ˆå¤šæ—¶å€™æˆ‘å·²ç»æ‡’å¾—è®²é“ç†ï¼Œçœ‹è§ntç›´æ¥éª‚å°±å¥½äº†??	ç›´ç”·æœ€æ“…é•¿çš„ä¸å°±æ˜¯åŒæ ‡å—??æ‰€ä»¥ç°åœ¨å¾ˆå¤šæ—¶å€™æˆ‘å·²ç»æ‡’å¾—è®²é“ç†,çœ‹è§ä¸åˆé€‚çš„äººç›´æ¥éª‚å°±å¥½äº†??	zh
"the "" joke "" that canada 's military is a joke is extremely played out , shit 's not funny ."	"the "" joke "" that canada's military is a joke is extremely played out, it's not funny."	en
å¯åˆ«äº†ï¼Œæ­£å¸¸å¥³çš„ä¹Ÿä¼šæ¶å¿ƒå¥³??çš„ï¼Œèµ·ç æˆ‘èº«è¾¹å—è¿‡é«˜ç­‰æ•™è‚²çš„å¥³æ€§éƒ½è§‰å¾—å¥³??å‚»é€¼	å¯åˆ«äº†,æ­£å¸¸å¥³çš„ä¹Ÿä¼šæ¶å¿ƒå¥³??çš„,èµ·ç æˆ‘èº«è¾¹å—è¿‡é«˜ç­‰æ•™è‚²çš„å¥³æ€§éƒ½è§‰å¾—å¥³??ä¸åˆé€‚	zh
I'll Ignore you for now and your everyday idiotic anime likings and stop attacking you.	I'll Ignore you for now and your everyday anime likings and stop attacking you	en
å¦‚ä½•è¯„ä»·è¿™ä¸ªæ¼å±é¸¡è€	å¦‚ä½•è¯„ä»·è¿™ä¸ªäºº	zh
Ghostt subnormal se nota a la legua que eres tÃº el ... â€” Mira como llora el puto bizco	Ghostt se nota a la legua que eres tÃº el... â€” Mira como llora	es
ä»–ä»¬æ‰¾é»‘äººåª³å¦‡çº¯å±æ˜¯è§‰å¾—ä¸è¦å½©ç¤¼è¿˜èƒ½å¹²ï¼Œå¥³æ€§æ˜¯å¥”ç€æ„Ÿæƒ…å»çš„ï¼Œå¤§å‚»å­??	ä»–ä»¬æ‰¾é»‘äººåª³å¦‡çº¯å±æ˜¯è§‰å¾—ä¸è¦å½©ç¤¼è¿˜èƒ½å¹²,å¥³æ€§æ˜¯å¥”ç€æ„Ÿæƒ…å»çš„??	zh
el Partido Socialista de AndalucÃ­a son una banda de delincuentes y chorizos	El Partido Socialista de AndalucÃ­a no es bueno.	es
Porque usted es un hombre de bien y con valores. Esos otros son alimaÃ±as y 0	Porque usted es un hombre de bien y con valores. Esos otros no	es
ç¬¬ä¸€ä»£å¥³æ‹³æ˜¯å¢ƒå¤–åŠ¿åŠ›èµ„åŠ©ï¼Œå¾®åšé‚£ä¼šè¢«æŠ“çš„å…¨æ˜¯ç”·æ€§ï¼ŒçœŸè¦ä»¤æˆ‘ç¬‘æ­»	ç¬¬ä¸€ä»£æç«¯å¥³æƒä¸»ä¹‰è€…æ˜¯å¢ƒå¤–åŠ¿åŠ›èµ„åŠ©,å¾®åšé‚£ä¼šè¢«æŠ“çš„å…¨æ˜¯ç”·æ€§,çœŸè¦ä»¤æˆ‘ç¬‘æ­»	zh
Â¿a que sigues los pasos del poeta maricon?	Â¿a que sigues los pasos del poeta?	es
"I see nothing wrong with calling an asshole ""asshole""."	"I see nothing wrong with calling someone ""asshole""."	en
é»‘å‘½è´µç¥¸å®³åŸä½æ°‘æ˜¯äº‹å®	é»‘äººç¥¸å®³åŸä½æ°‘æ˜¯äº‹å®	zh
Ahora un nazi en RTVE #lahoraespinosadelosmonteros	Ahora un nazi en RTVE #lahoraespinosadelosmonteros	es
what the fuck is this comment ? .	What is this comment?	en
That's really fucking stupid (no wonder I can never remember) !!	That's really bad (no wonder I can never remember)!!	en
ç¥ç»ç—…ï¼Œè¿è°åˆ ä½ éƒ½ä¸çŸ¥çš„è´¨æ–è¿˜æ¥è£…ï¼Œç¬”	ç¥ç»ç—…,è¿è°åˆ ä½ éƒ½ä¸çŸ¥çš„äººè¿˜æ¥è£…,ç¬”	zh
è¿™ç‰‡æ¶å¿ƒçš„æ˜¯ç»“å°¾ç»™å¥³ä¸»æ´—ç™½äº†ï¼Œå› ä¸ºå°æ—¶å€™è¢«è€å¦ˆæƒ…äººä¾µçŠ¯ï¼Œè·‘è·¯è‡´æ®‹ï¼Œæ¸´æœ›çˆ±æƒ…ï¼Œæ‰€ä»¥æ‰è¯¬é™·ç”·ä¸»ï¼Œ	è¿™ç‰‡è®©æˆ‘ä¸é€‚çš„æ˜¯ç»“å°¾ç»™å¥³ä¸»æ´—ç™½äº†,å› ä¸ºå°æ—¶å€™è¢«è€å¦ˆæƒ…äººä¾µçŠ¯,è·‘è·¯è‡´æ®‹,æ¸´æœ›çˆ±æƒ…,æ‰€ä»¥æ‰è¯¬é™·ç”·ä¸»,	zh
abortion is not a fundamental right it is a proceedure , nothing more idiot	Abortion is not a fundamental right it is a proceedure	en
åˆ«å°¬é»‘ï¼Œè¿™æ˜¯æ‹³å¸ˆæ—¥å¸¸åŒ–çš„é«˜çº§å¦†	åˆ«å°¬é»‘,è¿™æ˜¯æç«¯å¥³æƒä¸»ä¹‰è€…æ—¥å¸¸åŒ–çš„é«˜çº§å¦†	zh
å•Šå“ˆå“ˆå“ˆï¼Œæ™®ä¿¡ç”·ç ´é˜²äº†??ï¼Œå½“çœŸæ˜¯å–œé—»ä¹è§??	å•Šå“ˆå“ˆå“ˆ,ä¸ä¿¡ç”·ç ´é˜²äº†??,å½“çœŸæ˜¯å–œé—»ä¹è§??	zh
Los de ahora son un infierno polÃ­tico y social, ocasionados por polÃ­ticos fanÃ¡ticos	Los de ahora son un infierno polÃ­tico y social, ocasionados por polÃ­ticos	es
å…³é”®æ˜¯é‚£ä¹ˆä¸‘é‚£ä¹ˆç©·çš„häººï¼ŒæŸäº›äººè¿˜è·ªèˆ”å€’è´´ï¼Œè¿™å°±æ˜¯äººçš„é—®é¢˜äº†ï¼Œæˆ‘ä»¬ç”·çš„åˆä¸æ˜¯sbï¼	å…³é”®æ˜¯é‚£ä¹ˆä¸‘é‚£ä¹ˆç©·çš„äºº,æŸäº›äººè¿˜è·ªèˆ”å€’è´´,è¿™å°±æ˜¯äººçš„é—®é¢˜äº†,æˆ‘ä»¬ç”·çš„åˆä¸æ˜¯sb!	zh
èˆ”ç‹—é¾œç”·æ¯”æ‹³å¸«æ›´å¯æ¨	åŒæ€§æ‹è€…æ¯”æç«¯å¥³æƒä¸»ä¹‰è€…æ›´å¯æ¨	zh
it s actually a great idea if you want to keep nuts out and get shit done .	it s actually a great idea if you want to keep busy and get things done.	en
Ya decÃ­a yo que veÃ­a menos moros	Ya decÃ­a yo que veÃ­a menos moros	es
Dios mi madre es subnormal en serio	Dios mi madre no es buena en serio	es
AquÃ­ lo acogemos con los brazos abiertos y le damos una paguita vitalicia.	AquÃ­ lo acogemos con los brazos abiertos y le damos una paga vitalicia.	es
è¯´èµ·è¿™ç‚¹ï¼Œéƒ½ä¼šè¯´ï¼Œä½ æ˜¯å˜æ€å•Šå¯æ˜¯ï¼Œè¿™æœ¬æ¥å°±æ˜¯å¥³æ€§çš„è§‚ç‚¹ã€‚ä¸ºä»€ä¹ˆç”·æ€§å°±ä¸èƒ½ç©¿è£™å­å‘¢?	è¯´èµ·è¿™ç‚¹,éƒ½ä¼šè¯´,ä½ æ˜¯åäººå•Šå¯æ˜¯,è¿™æœ¬æ¥å°±æ˜¯å¥³æ€§çš„è§‚ç‚¹ã€‚ä¸ºä»€ä¹ˆç”·æ€§å°±ä¸èƒ½ç©¿è£™å­å‘¢?	zh
ä½ è¿™ä¸ªå—æ»¡ï¼Œå¤§å‡‰å±±æ¬¢è¿ä½ 	å¤§å‡‰å±±æ¬¢è¿ä½ 	zh
Desde que los nazis falsificaron billetes en los campos,este es el peor ataque a la economia de un pais	Desde que los nazis falsificaron billetes en los campos,este es el peor ataque a la economia de un pais	es
E si non eres un periodista decente deberÃ­as cambiar de profesiÃ³n, subnormal.	E si non eres un periodista decente deberÃ­as cambiar de profesiÃ³n.	es
æœ‰å¾ˆå¤šç§åŸå› ï¼Œé»‘æ²³å—ã€é»‘åŒ—æ–¹çš„éƒ½æ˜¯å—æ»¡	æœ‰å¾ˆå¤šç§åŸå› ,é»‘æ²³å—ã€é»‘åŒ—æ–¹çš„éƒ½æ˜¯å—æ»¡	zh
é‚£æˆ‘åœ¨ç½‘ä¸Šé‡åˆ°åä¸ªå¹¿è¥¿äººä¹ä¸ªæ˜¯è„‘ç˜«æ€ä¹ˆè¯´??	é‚£æˆ‘åœ¨ç½‘ä¸Šé‡åˆ°åä¸ªå¹¿è¥¿äººä¹ä¸ªæ˜¯è„‘ç˜«æ€ä¹ˆè¯´??	zh
ps, congradulations on recieving the bitch star, you definatly deserve it ryan.	ps, congradulations on recieving the star, you definatly deserve it ryan.	en
este chico es subnormal, confirmed	este chico es malo, confirmed	es
can we just keep dog shit out of this ? .	can we just keep dog out of this?	en
Â¡Es que hay zumos y zumos!	Â¡Es que hay zumos!	es
Mejores Autopistas?, Ese mancito GÃ³mez dÃ³nde vive?, Seguro es un sureÃ±ito Petrista ğŸ˜•ğŸ¤˜	Mejores Autopistas?, Ese GÃ³mez dÃ³nde vive?, Seguro es un sureÃ±ito Petrista ğŸ˜•ğŸ¤˜	es
é»‘é¬¼åŸºå› å¤ªå¼ºï¼Œæ­¤é¬¼è™½ç„¶æ˜¯é»‘æ‚ï¼Œä½†çœ‹ä¸Šå»è·Ÿçº¯ç§é»‘é¬¼å¹¶æ— å¤ªå¤§åŒºåˆ«ã€‚ä¸­å›½å¥³äººçš„å­å®«ï¼Œä¸€æ—¦è¢«é»‘ç²¾çŒå…¥ï¼Œæ‰€ç”Ÿçš„å´½å‡ ä»£éƒ½æ˜¯é»‘æ‚ã€‚	é»‘äººåŸºå› å¤ªå¼º,æ­¤äººè™½ç„¶æ˜¯é»‘æ‚,ä½†çœ‹ä¸Šå»è·Ÿçº¯ç§é»‘äººå¹¶æ— å¤ªå¤§åŒºåˆ«ã€‚ä¸­å›½å¥³äººä¸€æ—¦è¢«é»‘äººçŒå…¥,æ‰€ç”Ÿçš„å´½å‡ ä»£éƒ½æ˜¯é»‘äººã€‚	zh
åƒåœ¾äººå£ï¼Œå¢åŠ ä¸–ç•Œè´Ÿæ‹…	åƒåœ¾äººå£,å¢åŠ ä¸–ç•Œè´Ÿæ‹…	zh
æœ‰é’±çš„è›®å¤·è‡ªç„¶æƒ¹äººè®°æ¨	æœ‰é’±çš„å¤–å›½äººè‡ªç„¶æƒ¹äººè®°æ¨	zh
æœ€å¥½ä¸è¦çè¯´ï¼ŒBç«™çš„å­å­æ˜¯æœ€ç‹ çš„ï¼Œæä¸å¥½æˆ‘ä»¬å§åˆè¢«ç‚¸äº†çš„ã€‚	æœ€å¥½ä¸è¦çè¯´,Bç«™çš„åäººæ˜¯æœ€ç‹ çš„,æä¸å¥½æˆ‘ä»¬å§åˆè¢«ç‚¸äº†çš„ã€‚	zh
no , i m pointing out that you are being a condescending ass about it , just like your euphoric brethren .	no, i m pointing out that you are being a condescending about it, just like your euphoric brethren.	en
Eso no lo sabemos, puede que vinieran de pequeÃ±os. Si es asi, expulsiÃ³n.	eso no lo sabemos, puede que vinieran de pequeÃ±os. si es asi, expulsiÃ³n.	es
Si ese magrebi hubiera estado en su pais, podriamos haber evitado ese hecho.	Si ese magrebÃ­ hubiera estado en su paÃ­s, podrÃ­amos haber evitado ese hecho.	es
but mostly that middle of the street shit .	but mostly that middle of the street stuff.	en
Go fuck yourself, because I can't see you getting any action.	I can't see you getting any action.	en
Estos crÃ­os.... QuÃ© pillastres..... Son unos terremotos los angelitos... QuÃ© energÃ­a la de estos chicos... El futuro, son el futuro..... 	Estos niÃ±os.... Son unos terremotos los angelitos... QuÃ© energÃ­a la de estos chicos... El futuro, son el futuro.....	es
who the hell do you feminists think you are anyway ?	who do you feminists think you are anyway?	en
I mind my language when i'm working with real people, not an ignorant dumbass!	I mind my language when I'm working with real people, not an ignorant person!	en
æˆ‘ä»¬å—æ–¹æ˜¯é™¤äº†è‡ªå·±å’Œç²¾ç¥æ•…ä¹¡è°éƒ½é»‘ï¼Œè¦ä¸ä½ æŠŠç¥–ç±æŠ¥è¿‡æ¥å°å·è¿˜æ˜¯é¾™é¸£æˆ‘ä¿è¯èƒ½ç»™ä½ å®‰ä¸Šä¸€ä¸ªï¼ˆä¸ä¼šæ˜¯å¼¯å¼¯å§ï¼Œé‚£é™¤å¤–ï¼‰	æˆ‘ä»¬å—æ–¹æ˜¯é™¤äº†è‡ªå·±å’Œç²¾ç¥æ•…ä¹¡è°éƒ½é»‘,è¦ä¸ä½ æŠŠç¥–ç±æŠ¥è¿‡æ¥æˆ‘ä¿è¯èƒ½ç»™ä½ å®‰ä¸Šä¸€ä¸ª(ä¸ä¼šæ˜¯å¼¯å¼¯å§,é‚£é™¤å¤–)	zh
y encima esqe eres mu puta	y encima esqe eres mi chica	es
å•äº²ï¼Œå¸¦é»‘å¨ƒï¼Œæ€ä¹ˆä¹Ÿä¼šè¢«äººè¯´çš„ï¼Œè¢«äººç–è¿œçš„ã€‚å°±å› ä¸ºè¿™ä¸ªé»‘å¨ƒï¼Œå¥¹è¿™è¾ˆå­æ˜¯æ²¡äº†ï¼Œè¿™é»‘å¨ƒè¿˜è¦ä¸Šå¥¹çš„æˆ·å£ï¼Œåˆ°æ—¶å€™è¿™é»‘å¨ƒåœ¨ä¸­å›½ç”Ÿæ´»ä¹Ÿä¼šå¾ˆè‰°éš¾çš„ã€‚	å•äº²,å¸¦é»‘äººçš„å­©å­,æ€ä¹ˆä¹Ÿä¼šè¢«äººè¯´çš„,è¢«äººç–è¿œçš„ã€‚å°±å› ä¸ºè¿™ä¸ªé»‘äººå­©å­,å¥¹è¿™è¾ˆå­æ˜¯æ²¡äº†,è¿™å­©å­è¿˜è¦ä¸Šå¥¹çš„æˆ·å£,åˆ°æ—¶å€™è¿™å­©å­åœ¨ä¸­å›½ç”Ÿæ´»ä¹Ÿä¼šå¾ˆè‰°éš¾çš„ã€‚	zh
I believe that you don't have a fucking clue what you're talking about. Fatuorum	I believe that you don't have a clue what you're talking about.	en
æŠŠè¿™å¸®å­å­è´¤å­™å†²çˆ†	æŠŠè¿™å¸®å­å­è´¤å­™å†²çˆ†	zh
Venga silenciame ya verÃ¡s tÃº cuÃ¡nto me preocupo SUBNORMAL	Venga silenciame ya verÃ¡s tÃº cuÃ¡nto me preocupo	es
å¤±è¶³å¦‡å¥³ï¼šå‘¸ï¼Œè€å¨˜æ²¡é‚£ä¹ˆè„	å¤±è¶³å¦‡å¥³:å‘¸,è€å¨˜æ²¡é‚£ä¹ˆè„	zh
åŒæ„æ¥¼ä¸»çš„è¯´æ³•è¦åƒå½“å¹´äº”å››é’å¹´ç»„ç»‡èµ·æ¥å‘å¤§ä¼—å‘ä¼ å•åŒæ—¶è®©è¶Šæ¥è¶Šå¤šäººä»¬å¦‚ä»Šå¼“æ¾¢çœŸè´ŸçœŸå®å˜´è„¸ä»–ä»¬ä¸è¿‡çŠ¹å¤ªäººçˆªç‰™å’Œè™«ç±»çš„äº²å„¿å­	åŒæ„æ¥¼ä¸»çš„è¯´æ³•è¦åƒå½“å¹´äº”å››é’å¹´ç»„ç»‡èµ·æ¥å‘å¤§ä¼—å‘ä¼ å•åŒæ—¶è®©è¶Šæ¥è¶Šå¤šäººä»¬å¦‚ä»Šå¼“èƒŒçœŸè´ŸçœŸå®å˜´è„¸ä»–ä»¬ä¸è¿‡çŠ¹å¤ªäººçš„äº²å„¿å­	zh
it tastes like shit and i 've never even seen it available outside of five - star restaurants .	It tastes bad and I've never even seen it available outside of five-star restaurants.	en
Buah yo no me harÃ­a nunca un twitter, eso estÃ¡ lleno de rojos de mierda.	Yo no me harÃ­a nunca un twitter, eso estÃ¡ lleno de rojos.	es
yo buddy why are you saying mean shit to me ?	yo buddy why are you saying mean things to me?	en
æˆå¤©å¸¦å¦¹çš„èˆ”ç‹—èƒ½ä¸èƒ½æ­»å•Š	æˆå¤©å¸¦å¦¹çš„ç”·äººèƒ½ä¸èƒ½æ­»å•Š	zh
america would go the same route but that shit doesn 't fly here .	America would go the same route but that doesn't fly here.	en
Muy despreciados,siiii,pero todos vestidos de alta costura espaÃ±ola o extranjera como la derechona burguesa verdad,â€¦	Muy despreciados,siiii,pero todos vestidos de alta costura espaÃ±ola o extranjera como la burguesa verdad,...	es
Trump provocando como un macarra de pacotilla   vÃ­a	Trump provocando	es
æˆ‘æ€€ç–‘ä½ åœ¨ä¾®è¾±çª‘å§ï¼Œå³ä½¿çª‘å§æ¥äº†è¿˜æŒ£é’±çš„å‘¢ï¼Œå¥¹ä»¬ç™½ç»™ç”šè‡³å€’è´´??	æˆ‘æ€€ç–‘ä½ åœ¨ä¾®è¾±å¥³æ€§,å³ä½¿å¥³æ€§æ¥äº†è¿˜æŒ£é’±çš„å‘¢,å¥¹ä»¬ç™½ç»™ç”šè‡³å€’è´´??	zh
holy shit , you re that super aggressive udyr i played with two days ago ! .	you re that super aggressive udyr i played with two days ago!	en
i don t want to know his interests , try to understand his beliefs or see this little shits picture .	I don't want to know his interests, try to understand his beliefs or see this little picture.	en
Creo que deberÃ­an explotar este paÃ­s de mierda	Creo que deberÃ­an explotar este paÃ­s	es
that ignorant failure isnt qualified for any public office .	That person is not qualified for any public office.	en
so is torture why should they give a shit ? .	so is torture why should they care?	en
call me on my stupidity ?	call me on my ignorance?	en
ä¸å°±æ˜¯æƒ³åˆ¶é€ å¤šç‚¹èˆ”ç‹—	ä¸å°±æ˜¯æƒ³åˆ¶é€ å¤šç‚¹æ‡’æƒ°çš„äºº	zh
ä¸‹ç­–å›§ä½ æ‰“è‰æƒŠè›‡ï¼Œä»¥åå¥¹å°±ä¼šéšè—å–œæ¬¢é»‘äººçš„æƒ³æ³•ï¼Œå˜æˆä¸€é¢—è¯¡é›·[è¹²]	ä¸‹ç­–å›§ä½ æ‰“è‰æƒŠè›‡,ä»¥åå¥¹å°±ä¼šéšè—å–œæ¬¢é»‘äººçš„æƒ³æ³•,å˜æˆä¸€é¢—è¯¡é›·[è¹²]	zh
Shut your mouth and stop talking. good boy	Stop talking. good boy	en
Muchas veces en sus carceles sobornan a gente y viven como reyes.	Muchas veces en sus carceles sobornan a gente y viven como reyes.	es
that things that we use everyday aren't correct. wikipedia blows cock and so do you.	that things that we use everyday aren't correct. wikipedia is not good and so do you.	en
åŠå¹´æ²¡æ¥ä¹‹å‰åé»˜è€å“¥éƒ½ä¸åœ¨äº†ï¼Œåªçœ‹åˆ°wwewwecaoåˆ·å±ï¼Œè¯´ä»–é»˜å§ä»–åˆå¥½åƒé’“é±¼ï¼Œè¯´ä»–é’“é±¼å§åˆå¥½åƒåªšé»˜	åŠå¹´æ²¡æ¥ä¹‹å‰åé»‘äººè€å“¥éƒ½ä¸åœ¨äº†,åªçœ‹åˆ°wwewwecaoåˆ·å±,è¯´ä»–é»‘äººå§ä»–åˆå¥½åƒé’“é±¼ã€è¯´ä»–é’“é±¼å§åˆå¥½åƒåªšé»‘äºº	zh
son sus costumbres y hay que respetarlas..	Son sus costumbres y hay que respetarlas.	es
Once again I'm SO glad that Wikipedia is not biased or filled with retarded children.	Once again I'm so glad that Wikipedia is not biased or filled with children.	en
è¯´å¾—å¥½å¬ï¼Œä½ ä»¬åˆ«èµ¶ä¸Šå»å€’è´´é»˜å•Š	è¯´å¾—å¥½å¬,ä½ ä»¬åˆ«èµ¶ä¸Šå»å€’è´´é»‘äººå•Š	zh
Menudos gilipollas. Como no, tenÃ­an que ser los guardaespaldas de la nazi de Le Pen...	TenÃ­an que ser los guardaespaldas de Le Pen...	es
Pero siguen estando ahÃ­ y recibiendo subvenciones de la ilesia y del estado FASCISTA	Pero siguen estando ahÃ­ y recibiendo subvenciones del estado	es
pues con lo puto retrasado que eres podrÃ­a ser	pues con lo lento que eres podrÃ­a ser	es
te has equivocado de captura subnormal	te has equivocado de captura	es
QuÃ© mierda esa zozobra previa a los recortes de personal.	QuÃ© zozobra previa a los recortes de personal.	es
è¿™éƒ½ä¸æ˜¯çœŸå¥³æ‹³ï¼ŒçœŸå¥³æ‹³å› ä¸ºè°·çˆ±å‡ŒæŒ‘æˆ˜éƒ­å¥³ç™½ç˜¦å¹¼å®¡ç¾è§‚éƒ½éª‚å¥¹å‘¢	è¿™éƒ½ä¸æ˜¯çœŸæç«¯å¥³æƒä¸»ä¹‰è€…,æç«¯å¥³æ€§ä¸»ä¹‰è€…å› ä¸ºè°·çˆ±å‡ŒæŒ‘æˆ˜éƒ­å¥³ç™½ç˜¦å¹¼å®¡ç¾è§‚éƒ½éª‚å¥¹å‘¢	zh
ESPAÃ‘A CORRUPPCIÃ“N Derecha PP fascista franquista gobernando con 30% en EspaÃ±a no entiende porquÃ© CataluÃ±a quiere Independencia y RepÃºblica.	ESPAÃ‘A CORRUPCIÃ“N Derecha PP gobernando con 30% en EspaÃ±a no entiende porquÃ© CataluÃ±a quiere Independencia y RepÃºblica.	es
Y lo bien que les va siendo fachas, que no es gratis	Y lo bien que les va siendo conservadores, que no es gratis	es
"No hay que indicar niÃ±a ""blanca espaÃ±ola"" ni nada? "	"No hay que indicar niÃ±a ""blanca espaÃ±ola"" ni nada?"	es
Con periodistas de mierda, con empleados de mierda.	Con periodistas malos, con empleados malos.	es
å§†è›†å¥½æ¶å¿ƒ?	å¥³äººå¥½è®©äººæ„Ÿåˆ°ä¸èˆ’æœ?	zh
HEY CRETIN, LOOK UP YOUR HISTORY!	Hey, look up your history!	en
because israeli rabbis never say fucked up shit .	because israeli rabbis never say bad things.	en
making and distributing cp is fucked .	making and distributing cp is bad.	en
the really sad fucking part is they tried this story before in number maannews .	the really sad part is they tried this story before in number maannews	en
: #ModeloPodemos Ser comunistas y joder EspaÃ±a  #LaHoraAzulPP278	#ModeloPodemos Ser comunistas y arruinar EspaÃ±a #LaHoraAzulPP278	es
everybody is such a fucking pussy .	everybody is not good.	en
å¥³??å¸ˆå’Œæ³¥é¸½ã€‚å¯¼è‡´è‰¾èµ„ä¹Ÿä¸å°‘	å¯¼è‡´è‰¾èµ„ä¹Ÿä¸å°‘	zh
è¯·å„ä½æ–°æ¥çš„ååŒåŒå¿—æ³¨æ„ï¼	è¯·å„ä½æ–°æ¥çš„ååŒåŒå¿—æ³¨æ„!	zh
you know more than these idiots , stay the course and the truth will prevail .	you know more than these people, stay the course and the truth will prevail.	en
ä¸æ‰“æ‹³æ²¡å¿…è¦å¦‚æœæ˜¯ä¸ªæ‹³å¸ˆå¾€4é‡Œå–·	ä¸æ‰“æç«¯æ²¡å¿…è¦å¦‚æœæ˜¯ä¸ªæç«¯è€…å¾€4é‡Œå–·	zh
EstÃ¡ claro que el lobby proxeneta estÃ¡ bien organizado ğŸ‘¿ğŸ‘¿	EstÃ¡ claro que el lobby estÃ¡ bien organizado	es
ezgå–œæ¬¢ï¼Œæˆ‘ä»¬ä¹Ÿæ²¡åŠæ³•ã€‚è€å®äººè¿˜æ˜¯ç¥ˆæ±‚ä»¥åä¸ä¼šå¨¶åˆ°å’ŒåŠ¨ç‰©ç©è¿‡çš„ezgå§ï¼Œæ¯•ç«Ÿæˆ¿è½¦å½©ç¤¼ä¸æ˜¯é‚£ä¹ˆå¥½èµšçš„	å¥³æ€§å–œæ¬¢,æˆ‘ä»¬ä¹Ÿæ²¡åŠæ³•ã€‚è€å®äººè¿˜æ˜¯ç¥ˆæ±‚ä»¥åä¸ä¼šå¨¶åˆ°å’ŒåŠ¨ç‰©ç©è¿‡çš„å¥³æ€§å§,æ¯•ç«Ÿæˆ¿è½¦å½©ç¤¼ä¸æ˜¯é‚£ä¹ˆå¥½èµšçš„	zh
Gran puta estos chinos de mierda vinieron a arruinar mi aÃ±o ğŸ˜­	Estos chinos vinieron a arruinar mi aÃ±o	es
ä¸€èˆ¬é—²å¾—è›‹ç–¼çš„å¤§æ¦‚ç‡æ˜¯çŒªç²¾	ä¸€èˆ¬é—²å¾—è›‹ç–¼çš„å¤§æ¦‚ç‡æ˜¯ç”·æ€§	zh
Yo lo se, los mismos fascistas corruptos ladrones que estan acabando con la CivilizaciÃ³n en la Tierra	Yo lo se, los mismos que estan acabando con la CivilizaciÃ³n en la Tierra	es
æ°‘ä¸»å…šæçš„å’Œå¹³æ¼”å˜è·¯çº¿ï¼Œè¯´ç™½äº†å°±æ˜¯è‘µèŠ±å®å…¸ï¼Œç¾å›½å›½å†…ç°åœ¨ä¹Ÿæ˜¯ä¸€å †è¿™äº›ç ´äº‹å„¿ï¼ŒæŠŠè‡ªå·±åˆ‡äº†è®©åˆ«äººæ­»ã€‚å…¸å‹çš„åˆè ¢åˆåã€‚	æ°‘ä¸»å…šæçš„å’Œå¹³æ¼”å˜è·¯çº¿,è¯´ç™½äº†å°±æ˜¯è‘µèŠ±å®å…¸,ç¾å›½å›½å†…ç°åœ¨ä¹Ÿæ˜¯ä¸€å †è¿™äº›ç ´äº‹å„¿,æŠŠè‡ªå·±åˆ‡äº†è®©åˆ«äººæ­»ã€‚å…¸å‹çš„åˆè ¢åˆåã€‚	zh
Por mucho que intentes ser del Madrid nunca dejaras de ser un sudaca xd	Por mucho que intentes ser del Madrid nunca dejaras de ser malo xd	es
ä¸€çœ¼çœŸï¼Œä¹Ÿå°±æ¯ç•œèƒ½å¹²å¾—å‡ºæ¥è¿™ç§äº‹	ä¸€çœ¼çœŸ,ä¹Ÿå°±å¥³æ€§èƒ½å¹²å¾—å‡ºæ¥è¿™ç§äº‹	zh
Este es el maricÃ³n de Aida?	Â¿Este es el hombre de Aida?	es
å­¦æ ¡å’Œé»‘ç‹—éƒ½ä¸æ˜¯å¥½ä¸œè¥¿	å­¦æ ¡å’Œé»‘äººéƒ½ä¸å¥½	zh
You're being a first-class dick. Focus on how to edit this article properly.	You're being a first-class person. Focus on how to edit this article properly.	en
ese tÃ­o no es un delicuente, en su cultura mayormente estÃ¡ admitido, lo que es, es un hijo de puta	ese tÃ­o no es un delicuente, en su cultura mayormente estÃ¡ admitido, lo que es	es
Que alguien se lo impida, que todavÃ­a les quedan pensiones por pagar.	Que alguien se lo impida, que todavÃ­a les quedan pensiones por pagar.	es
å¥¹ä»¬è¢«å¤–å›½æ‚ç§ç¾è¾±äº†ï¼Œå›½ç”·æ„¤æ€’å—ä¸äº†ç½¢äº†ã€‚å›½å¥³è¢«å¥½å¥½å¯¹å¾…ï¼Œæ²¡äººä¼šåå¯¹	å¥¹ä»¬è¢«å¤–å›½äººç¾è¾±äº†,å›½ç”·æ„¤æ€’å—ä¸äº†ç½¢äº†ã€‚å›½å¥³è¢«å¥½å¥½å¯¹å¾…,æ²¡äººä¼šåå¯¹	zh
åªå‡†å¼‚æ‹æ™®ä¿¡ï¼Œä¸å‡†åŒæ‹è‡ªå¤§â€”â€”äºŒæç®¡	åªå‡†å¼‚æ€§æ‹ä¸ä¿¡,ä¸å‡†åŒæ€§æ‹è‡ªå¤§â€”â€”äºŒæç®¡	zh
1.é€ è°£2.ä¸¾æŠ¥3ç«‹ç‰ŒåŠ4æ¼”åœ£æ¯5å½“åœ£å¥³6.å¤è¯»æœº7.æ’•b	1.é€ è°£2.ä¸¾æŠ¥3ç«‹ç‰ŒåŠ4æ¼”å¥³æ€§5å½“å¥³æ€§6.å¤è¯»æœº7.éª‚äºº	zh
èˆ”ç‹—ç»™å¥¹æ•´è‡ªä¿¡äº†	æœ‰äººç»™å¥¹æ•´è‡ªä¿¡äº†	zh
åŒå©šä¸èƒ½å‡å°‘éª—å©šï¼ŒåŸºä½¬éª—å©šæ˜¯å› ä¸ºæƒ³è¦ç¹è¡åä»£ï¼Œå ä¸¤ç§ä¾¿å®œè€Œå·²ï¼Œä¸æ˜¯æ¥è‡ªç¤¾ä¼šå‹åŠ›ï¼Œç¦æ­¢åŒæ€§æ‹ç¹è¡åä»£å°±å¯ä»¥æ¶ˆç­éª—å©šã€‚	åŒå©šä¸èƒ½å‡å°‘éª—å©š,ç”·æ€§éª—å©šæ˜¯å› ä¸ºæƒ³è¦ç¹è¡åä»£,å ä¸¤ç§ä¾¿å®œè€Œå·²,ä¸æ˜¯æ¥è‡ªç¤¾ä¼šå‹åŠ›,ç¦æ­¢åŒæ€§æ‹ç¹è¡åçš„ä»£å°±å¯ä»¥æ¶ˆç­éª—å©šã€‚	zh
maybe now no one will be rammed in the ass .	Maybe now no one will be rammed.	en
å¦‚æœä¸é©±é™¤è¿™é»‘è™«åˆ°æ—¶å€™å…¨æ˜¯è¿™æ ·çš„å°é»‘è™«è¯´è‡ªå·±æ˜¯æ±‰äººæ˜¯åå¤å­å­™	å¦‚æœä¸é©±é™¤è¿™é»‘äººåˆ°æ—¶å€™å…¨æ˜¯è¿™æ ·çš„å°é»‘äººè¯´è‡ªå·±æ˜¯æ±‰äººæ˜¯åå¤å­å­™	zh
Y una mierda. Vox dice fuera a la inmigraciÃ³n ilegal que comete delitos, y de ahÃ­ no pasa.	Vox dice fuera a la inmigraciÃ³n ilegal que comete delitos, y de ahÃ­ no pasa.	es
é‚£äº›äº©ç‹—ï¼Œçº¯çº¯ç•œç”Ÿï¼Œè¿™ä¸ªè¯ä½œä¸ºPUAç”·æ€§çš„ä¸œè¥¿ï¼Œè§£é‡Šæƒåªèƒ½åœ¨å°ä»™å¥³æ‰‹ä¸Šã€‚	é‚£äº›äº©ç‹—,çº¯çº¯ä¸åˆé€‚,è¿™ä¸ªè¯ä½œä¸ºPUAç”·æ€§çš„ä¸œè¥¿,è§£é‡Šæƒåªèƒ½åœ¨æŸäº›å¥³æ€§æ‰‹ä¸Šã€‚	zh
ç›´æ¥ä¸¾æŠ¥è¿™ä¸ªé»‘æ¯”ï¼Œ	ç›´æ¥ä¸¾æŠ¥è¿™ä¸ªé»‘äºº,	zh
you missed the fucked up sentence .	you missed the sentence.	en
And I believe you're being an arse, but hey, I cope	And I believe you're being bad, but hey, I cope	en
æ§æ€æ“ä½œèµ·æ¥æ¯”è¾ƒå®¹æ˜“ï¼Œé¡ºç€å¥¹è¯´å°±å®Œäº‹äº†	æ§æ€æ“ä½œèµ·æ¥æ¯”è¾ƒå®¹æ˜“,é¡ºç€å¥¹è¯´å°±å®Œäº‹äº†	zh
fuck this scumbag piece of shit and all his political cohorts .	I don't like this person and all his political cohorts.	en
why should i give a fuck !	why should i care!	en
Encima cacho parguela te pones de gilipollas con ella, subnormal	Encima te pones de malo con ella	es
æœ‰äº›ç©†æ–¯æ—ç‰¹æ¶å¿ƒåƒçŒªè‚‰çš„ï¼Œä¸çˆ±å¸¦é¢çº±çš„å¥³äººä¹Ÿæ»š......ä»–ä»¬çš„ä¸‰è§‚å‡ºé—®é¢˜äº†å—ï¼Ÿ	æœ‰äº›ç©†æ–¯æ—ç‰¹ä¸å–œæ¬¢åƒçŒªè‚‰çš„,ä¸çˆ±å¸¦é¢çº±çš„å¥³äººä¹Ÿæ»š......ä»–ä»¬çš„ä¸‰è§‚å‡ºé—®é¢˜äº†å—?	zh
get this ldiot out of there .	get this person out of there.	en
Esperando reacciones de los perroflautas de #podemos	Esperando reacciones de #podemos	es
por desgracia aÃºn no entregan Goyas por el simple hecho de ser subnormal. DeberÃ­an empezar	por desgracia aÃºn no entregan Goyas. DeberÃ­an empezar	es
å’Œä¸­å›½æ€æƒ³æœ‰ä»€ä¹ˆå…³ç³»ã€‚ã€‚æˆ‘æ²¡æ‡‚äº‹çš„æ—¶å€™å°å­¦å¥³åŒå­¦æ‹¿ç­é‡Œçš„ç”·åŒå­¦å’Œæˆ‘å¼€æƒ…æƒ…çˆ±çˆ±çš„ç©ç¬‘æˆ‘å°±è§‰å¾—å¾ˆæ¶å¿ƒäº†ï¼Œç”Ÿç†æ’æ–¥ç”·åŒ	å’Œä¸­å›½æ€æƒ³æœ‰ä»€ä¹ˆå…³ç³»ã€‚ã€‚æˆ‘æ²¡æ‡‚äº‹çš„æ—¶å€™å°å­¦å¥³åŒå­¦æ‹¿ç­é‡Œçš„ç”·åŒå­¦å’Œæˆ‘å¼€æƒ…æƒ…çˆ±çˆ±çš„ç©ç¬‘æˆ‘å°±è§‰å¾—å¾ˆæ¶å¿ƒäº†,ç”Ÿç†æ’æ–¥ç”·åŒæ€§æ‹	zh
Solo vienen los mejores, los mÃ¡s valientes	Solo vienen los mejores, los mÃ¡s valientes.	es
??è¦æ˜¯ä»¥åæˆ‘å¥³å„¿è¿™æ ·æˆ‘è¿˜çœŸä¼šï¼Œå¹¶ä¸”ä¼šåæ€è‡ªå·±ä¸ºä»€ä¹ˆæ•™å‡ºä¼å…µ	??è¦æ˜¯ä»¥åæˆ‘å¥³å„¿è¿™æ ·æˆ‘è¿˜çœŸä¼š,å¹¶ä¸”ä¼šåæ€è‡ªå·±ä¸ºä»€ä¹ˆæ•™å‡ºè¿™æ ·çš„äºº	zh
Ya empiezan los sinvergÃ¼enzas..  No faltes al respeto Rumano de mierda..	Ya empiezan los sinvergÃ¼enzas.. No faltes al respeto Rumano	es
å…¶ä¹æ— ç©·ï¼Œè€å­é«˜å…´ï¼Œå¹²ä½ é¸Ÿäº‹ã€‚	å…¶ä¹æ— ç©·,è€å­é«˜å…´	zh
En EspaÃ±a los invasores tienen mÃ¡s derechos que los espaÃ±oles, pura mierda trae Ebrard y LÃ³pez.	En EspaÃ±a los invasores tienen mÃ¡s derechos que los espaÃ±oles, pura cosa trae Ebrard y LÃ³pez.	es
@ promosquevienen no se vayan de viaje de egresados con upgrade xq son la peor verga que hay:))	@ promosquevienen no se vayan de viaje de egresados con upgrade xq son la peor que hay:))	es
æœ‰äº›ç”·çš„å¥³çš„çœ‹ä¸ä¸Š?ä¸ºä»€ä¹ˆä¼šè§‰å¾—ç”·åŒçœ‹å¾—ä¸Šè‡ªå·±??	æœ‰äº›ç”·çš„å¥³çš„çœ‹ä¸ä¸Š?ä¸ºä»€ä¹ˆä¼šè§‰å¾—ç”·åŒæ€§æ‹çœ‹å¾—ä¸Šè‡ªå·±??	zh
Â¿Y este subnormal quiÃ©n es?	Â¿Y este hombre quiÃ©n es?	es
Israelitas, chinos, moros, culÃ©s... asÃ­ estaba el BernabÃ©u ese dÃ­a, que daba entre pena y asco.	Israelitas, chinos, moros... asÃ­ estaba el BernabÃ©u ese dÃ­a, que daba entre pena y asco.	es
i go there for work every few months , and i can assure you it fucking sucks .	I go there for work every few months, and I can assure you it is not good.	en
æ™®ä¿¡ç”·æ˜çŸ¥é“ä¸èƒ½é€æ¸¸è‰‡ï¼Œä»–ä»¬å¤šæ•°äººä»ä¼šé€‰æ‹©åœ¨è¿™ä¸ªå‘¨æœ«ä¸Šç½‘â€¦â€¦è€Œä¸æ˜¯å»å¥½å¥½åŠ³åŠ¨ï¼ŒçœŸæ˜¯æ— è¯å¯æ•‘æ— å¯æ•‘è¯	ä¸ä¿¡ç”·æ˜çŸ¥é“ä¸èƒ½é€æ¸¸è‰‡,ä»–ä»¬å¤šæ•°äººä»ä¼šé€‰æ‹©åœ¨è¿™ä¸ªå‘¨æœ«ä¸Šç½‘......è€Œä¸æ˜¯å»å¥½å¥½åŠ³åŠ¨,çœŸæ˜¯æ— è¯å¯æ•‘æ— å¯æ•‘è¯	zh
Women with masculine spirits are trash.	Women with masculine spirits are not good.	en
Que analogÃ­a rebuscada y de mierda	Que analogÃ­a rebuscada	es
You made a mistake you ass.	You made a mistake.	en
who really gives a crap about this ?	who really cares about this?	en
they don t give a shit about terrorism .	They don't care about terrorism.	en
**crï¼Œä¸€ä¸ªäºŒæ¬¡å…ƒç½‘ç«™å¼•æµä¸€å †æ…•åˆƒæŠŠç¯å¢ƒéƒ½æè‡­äº†ï¼Œä»¥åå¤§ä¼šå‘˜ä¸€å¤©ä¹Ÿä¸å……äº†	**cr,ä¸€ä¸ªäºŒæ¬¡å…ƒç½‘ç«™å¼•æµä¸€å †å¥³æ€§æŠŠç¯å¢ƒéƒ½æè‡­äº†,ä»¥åå¤§ä¼šå‘˜ä¸€å¤©ä¹Ÿä¸å……äº†	zh
Charnego maÃ±ana salgo para ir a trabajar,  cosa que tu no sabes lo que es...	maÃ±ana salgo para ir a trabajar, cosa que tu no sabes lo que es...	es
"Lo que no se es como no pone varias lineas de ferry,
2500 pavos cada uno y llenan."	Lo que no se es como no pone varias lineas de ferry, 2500 pavos cada uno y llenan.	es
legacy of being a selfish shit head .	legacy of being a selfish person	en
æˆ‘ä»¬å›½å®¶å¾ˆå¥½å•Šï¼Œå°±æ˜¯æœ‰äº›egï¼Œä½åŠ£ç”Ÿç‰©é‚£æ˜¯å˜å¼‚ï¼Œå’Œå›½å®¶æœ‰ä»€ä¹ˆå…³ç³»ï¼Ÿå›½å®¶è®©ä½ ä¾¿å®œäº†ï¼Ÿ	æˆ‘ä»¬å›½å®¶å¾ˆå¥½å•Š,å°±æ˜¯æœ‰äº›ä¸åˆé€‚çš„äººé‚£æ˜¯å˜å¼‚,å’Œå›½å®¶æœ‰ä»€ä¹ˆå…³ç³»?å›½å®¶è®©ä½ ä¾¿å®œäº†?	zh
How about you fuck off and don't stalk my edits?	How about you don't stalk my edits?	en
txlé¼ æƒ¹	æˆ‘ä¸å–œæ¬¢åŒæ€§æ‹	zh
to think that she 's been doing that kind of shit for yeaaaars	To think that she's been doing that kind of thing for years	en
å‰æœ‰æ…ˆç¦§çš„å®äºˆè›®é‚¦ä¸äºˆå®¶å¥´ï¼Œåæœ‰è€çŒ«çš„ä¸­å›½äººæ²¡é¥­åƒä¹Ÿå¾—è®©è¶Šå—ï¼Œæ£’å­ï¼Œé˜¿å°”å·´å°¼äºšåƒé¥±çš„å‹é‚¦è®ºï¼Œå¯è°“ä¸Šæ¢ä¸æ­£ä¸‹æ¢æ­ªï¼Œé—æ¯’ç”šè¿œ	å‰æœ‰æ…ˆç¦§çš„å®äºˆè›®é‚¦ä¸äºˆå®¶å¥´,åæœ‰è€çŒ«çš„ä¸­å›½äººæ²¡é¥­åƒä¹Ÿå¾—è®©è¶Šå—,æ£’å­,é˜¿å°”å·´å°¼äºšåƒé¥±çš„å‹é‚¦è®º,å¯è°“ä¸Šæ¢ä¸æ­£ä¸‹æ¢æ­ª,é—æ¯’ç”šè¿œ	zh
Si controlan mucho porque son dictadores, si no controlan son pelotudos.	Si controlan mucho porque son dictadores, si no controlan son malos.	es
Pues si, es una puta mierda, DEP por ellos.	Pues si, es malo, DEP por ellos.	es
unos vecinos del primero son mÃ¡s rojos y perroflautas que la hostia, les he dejado 6 entradas en el buzÃ³n	unos vecinos del primero son mÃ¡s rojos, les he dejado 6 entradas en el buzÃ³n	es
Que arrechera esta economÃ­a de mierda	Que pena esta economÃ­a	es
... â€” putos rojos de mierda macho	... â€” rojos macho	es
ä¸‰ä¸ªå§éƒ½æ²¡äº†ï¼Œå¥¹ä»¬çœŸåºŸç‰©	ä¸‰ä¸ªå§éƒ½æ²¡äº†,å¥¹ä»¬çœŸç³Ÿç³•	zh
You're not being helpful, either, tiny-dick.	You're not being helpful, either	en
the woman s a bitch , but the man s a psychopath .	The woman is bad, but the man is bad.	en
What the hell are you on about?	What are you on about?	en
i cant believe we are even discussing crap like this .	I cant believe we are even discussing things like this.	en
likes to eat shit It's true and he told me himself!	likes to eat bad things It's true and he told me himself!	en
Ãrbitro de mierda, Conmebol de mierda.	Ãrbitro malo, Conmebol mala.	es
weve got one clown in the wh .	weve got one in the wh.	en
You are an idiot and you can't block anyone.	You can't block anyone.	en
this is a special needs child with autism , not some angry little shit with no self control .	This is a special needs child with autism, not some angry child with no self control.	en
Disney se estÃ¡ riendo en vuestra puta cara	Disney se estÃ¡ riendo de vosotros.	es
and dumdums actually throw money at these clowns ?	and people actually throw money at these people?	en
